# The ASF licenses this file to You under the Apache License, Version 2.0
# (the "License"); you may not use this file except in compliance with
# the License.  You may obtain a copy of the License at
#
#     http://www.apache.org/licenses/LICENSE-2.0
#
# Unless required by applicable law or agreed to in writing, software
# distributed under the License is distributed on an "AS IS" BASIS,
# WITHOUT WARRANTIES OR CONDITIONS OF ANY KIND, either express or implied.
# See the License for the specific language governing permissions and
# limitations under the License.

#-----------------------------------------------------------------------
#some test synonym mappings unlikely to appear in real input text
aaafoo => aaabar
bbbfoo => bbbfoo bbbbar
cccfoo => cccbar cccbaz
fooaaa,baraaa,bazaaa
淘宝 => 购物 买东西
淘宝,天猫,聚划算,一淘,阿里巴巴
上班 => 工作 干活
高兴,快乐,娱乐,兴奋
# Some synonym groups specific to this example
GB,gib,gigabyte,gigabytes
MB,mib,megabyte,megabytes
Television, Televisions, TV, TVs
#notice we use "gib" instead of "GiB" so any WordDelimiterFilter coming
#after us won't split it into two words.

# Synonym mappings can be used for spelling correction too
pixima => pixma

seo => 搜索引擎优化
阿堵物 => 孔方兄
阿芙蓉 => 福寿膏
阿谀 => 奉承
阿谀奉承 => 攀龙趋凤
哀肠百转 => 愁肠寸断
哀愁 => 忧愁
哀悼 => 悼念
哀怜 => 悯恻
哀求 => 请求
蔼然可亲 => 和蔼可亲
爱才如命 => 求贤若渴
爱财如命 => 一毛不拔
爱好 => 喜好
爱护 => 爱惜
爱慕 => 倾慕
爱妾 => 宠姬
爱情 => 恋爱
爱人如己 => 己饥己溺
爱惜 => 爱护
暧昧 => 暗昧
安不忘危 => 居安思危
安步当车 => 缓步徐行
安产 => 顺产
安定 => 安宁
安顿 => 安置
安放 => 安置
安分守己 => 乐天知命
安静 => 宁静
安居乐业 => 安身立命
安乐 => 安泰
安谧 => 静谧
安眠 => 安息
安宁 => 安定
安排 => 支配
安全 => 平安
安然无恙 => 平安无事
安若泰山 => 十拿九稳
安身立命 => 安居乐业
安适 => 安逸
安守故常 => 安分守己
安慰 => 抚慰
安稳 => 平稳
安息 => 安眠
安闲 => 清闲
安逸 => 安适
安营 => 扎营
安在 => 何在
安葬 => 埋葬
安枕无忧 => 高枕无忧
安置 => 安顿
谙熟 => 谙习
谙习 => 谙熟
按序 => 顺次
按照 => 依照
案卷 => 檀卷
暗藏 => 隐藏
暗潮 => 暗流
暗澹 => 惨然
暗斗 => 冷战
暗沟 => 阴沟
暗害 => 暗杀
暗号 => 记号
暗箭 => 冷箭
暗箭伤人 => 含沙射影
暗流 => 暗潮
暗码 => 密码
暗昧 => 暧昧
暗盘 => 黑市
暗杀 => 暗害
暗算 => 暗害
暗香 => 幽香
暗笑 => 窃笑
暗影 => 阴影
暗中 => 黑暗
肮脏 => 邋遢
昂首 => 举头
昂扬 => 高昂
熬炼 => 锻炼
翱翔 => 飞翔
鏖战 => 激战
傲岸 => 立崖岸
傲慢 => 狂妄
傲睨 => 渺视
傲睨万物 => 傲世轻物
傲睨一世 => 昂首望天
傲世轻物 => 傲睨万物
傲雪欺霜 => 坚贞不屈
傲卒多败 => 骄者必败
奥妙 => 奇妙
懊悔 => 后悔
懊恼 => 烦恼
八方受敌 => 四面楚歌
八竿子打不着 => 八棍子撂不着
八股 => 陈腔滥调
八棍子撂不着 => 八竿子打不着
八门五花 => 五花八门
八面见光 => 面面俱圆
八面玲珑 => 左右逢源
八面威风 => 气势汹汹
八字帖 => 发草帖
巴结 => 趋承
扒手 => 窃贼
拔除 => 铲除
拔锚 => 起锚
拔苗助长 => 揠苗助长
跋扈 => 专横
跋前踬后 => 动辄得咎
跋山涉水 => 四处奔波
跋文 => 后记
把臂而谈 => 促膝谈心
把持 => 操纵
把脉 => 切脉
把守 => 扼守
把稳 => 留意
把戏 => 花招
罢了 => 而已
罢免 => 免职
罢手 => 收手
霸道 => 强横
霸术 => 权术
霸占 => 占领
白痴 => 呆子
白搭 => 白费
白发 => 鹤发
白发苍颜 => 皓首苍颜
白发银须 => 庞眉皓发
白费 => 空费
白净 => 白皙
白驹过隙 => 光阴似箭
白腊 => 石蜡
白蜡 => 地蜡
白日飞升 => 白日升天
白日升天 => 白日飞升
白手 => 空手
白手起家 => 自食其力
白天 => 日间
白皙 => 白净
白云苍狗 => 沧海桑田
白种人 => 碧眼儿
白昼 => 白天
白 => 利剑
百般 => 千般
百步穿杨 => 弹无虚发
百尺竿头 => 扶摇直上
百辞莫辩 => 有口难言
百发百中 => 矢无虚发
百孔千疮 => 民生凋敝
百口 => 全家
百里挑一 => 凤毛麟角
百了千当 => 千了百当
百姓 => 庶民
百依百顺 => 言听计从
百战百胜 => 战无不胜
百折不回 => 百折不挠
百折不挠 => 绝不屈服
摆荡 => 挥动
摆架子 => 搭架子
摆列 => 胪列
摆设 => 陈设
摆脱 => 解脱
败北 => 战败
败坏 => 废弛
败尽家业 => 倾家荡产
败类 => 莠民
败露 => 败事
败事 => 败露
败兴 => 没趣
败行 => 劣行
拜把兄弟 => 结拜兄弟
拜别 => 离去
拜访 => 访问
拜鬼求神 => 求神拜鬼
拜候 => 访谒
拜会 => 拜见
拜见 => 拜会
拜年 => 贺年
拜托 => 请托
拜望 => 拜见
拜谒 => 拜见
扳缠不清 => 牵丝扳藤
扳话 => 攀话
扳连 => 牵涉
班门弄斧 => 布鼓雷门
班师 => 凯旅
般游 => 盘游
颁布 => 公布
颁发 => 发表
斑白 => 花白
斑点 => 雀斑
斑纹 => 花纹
搬动 => 挪动转移
搬家 => 迁居
搬迁 => 搬家
板屋 => 木屋
版图 => 疆土
办法 => 方法
办好 => 办妥
办理 => 解决
办事 => 做事
办妥 => 搞妥
半壁江山 => 荆棘铜驼
半斤八两 => 势均力敌
半晌 => 片刻
半数 => 折半
半途而废 => 前功尽弃
半推半就 => 不即不离
半信半疑 => 将信将疑
半夜 => 子夜
半子 => 女婿
伴随 => 随同
伴同 => 伴随
扮演 => 饰演
扮装 => 化装
拌合 => 搀和
拌杂 => 拌合
邦本 => 国脉
邦畿 => 版图
邦家之光 => 国家荣誉
邦交 => 国交
帮忙 => 协助
帮手 => 副手
帮凶 => 爪牙
帮助 => 赞助
榜书 => 署书
榜样 => 模范
傍晚 => 薄暮
傍友 => 清客
包办 => 经办
包庇 => 容隐
包藏祸心 => 心怀叵测
包抄 => 包围
包袱 => 累赘
包管 => 担保
包含 => 包括
包涵 => 原谅
包括 => 包含
包揽 => 包办
包罗 => 搜罗
包罗万象 => 应有尽有
包容 => 包涵
包围 => 包抄
包孕 => 包含
褒奖 => 嘉奖
宝贝 => 瑰宝
宝贵 => 名贵
宝缄 => 大札
宝塔 => 浮屠
宝物 => 宝贝
宝穴 => 铜山
饱经风霜 => 历尽沧桑
饱满 => 丰满
保镳 => 警卫
保持 => 坚持
保存 => 保留
保护 => 掩护
保举 => 推荐
保留 => 保存
保卫 => 守卫
保养 => 颐养
保证 => 包管
保重 => 珍重
鸨母 => 龟婆
堡垒 => 碉堡
报酬 => 待遇
报答 => 答谢
报告 => 申报
报告请示 => 汇报
报歉 => 道歉
抱病 => 罹病
抱残守缺 => 因循守旧
抱负 => 理想
抱恨 => 赍恨
抱歉 => 负疚
抱屈 => 受冤
抱头 => 捧头
抱头鼠窜 => 逃之夭夭
抱冤 => 抱屈
抱怨 => 埋怨
豹隐 => 遁世
暴动 => 暴乱
暴戾恣睢 => 穷凶极恶
暴露 => 裸露
暴露无遗 => 原形毕露
暴乱 => 暴动
暴虐 => 凶横
暴徒 => 歹徒
暴躁 => 急躁
暴政 => 虐政
爆仗 => 炮竹
爆竹 => 爆仗
卑鄙 => 卑劣
卑躬屈膝 => 奴颜媚骨
卑贱 => 卑下
卑劣 => 拙劣
卑劣手段 => 鬼蜮伎俩
卑视 => 奴视
卑微 => 低微
卑下 => 卑贱
杯弓蛇影 => 草木皆兵
悲哀 => 悲痛
悲惨 => 悲凉
悲悼 => 伤悼
悲观 => 消极
悲欢离合 => 离合悲欢
悲凉 => 凄凉
悲凄 => 凄切
悲泣 => 悲啼
悲伤 => 悲痛
悲叹 => 叹伤
悲啼 => 号泣
悲恸 => 悲哀
悲痛 => 悲哀
碑本 => 石本
碑帖 => 碑本
北斗 => 斗极
北风 => 寒风
北里 => 娼寮
备案 => 立案
背城借一 => 破釜沉舟
背道而驰 => 南辕北辙
背工 => 夹帐
背景 => 配景
背面 => 后头
背叛 => 反水
背信 => 背约
背约 => 背信
背注一掷 => 决一死战
被宠若惊 => 受宠若惊
被骗 => 受愚
奔波 => 奔走
奔驰 => 奔跑
奔忙 => 奔走
奔跑 => 奔驰
奔腾 => 奔跑
奔走 => 奔忙
本地 => 当地
本地货 => 土产
本分 => 天职
本籍 => 祖籍
本家儿 => 事主
本来 => 原来
本领 => 本事
本末倒置 => 舍本逐末
本年 => 今年
本钱 => 成本
本日 => 今天
本色 => 本质
本身 => 自己
本事 => 本领
本事儿 => 当事者
本位主义 => 个人主义
本相 => 原形
本心 => 素心
本性 => 天性
本性难移 => 个性难改
本原 => 来源根基
本旨 => 本心
本质 => 实质
本子 => 簿子
笨伯 => 蠢人
笨蛋 => 笨伯
笨头笨脑 => 傻里傻气
笨重 => 粗笨
笨拙 => 愚笨
崩溃 => 瓦解
逼近 => 切近亲近
逼良为娼 => 迫良为娼
逼迫 => 强迫
逼上梁山 => 揭竿而起
逼真 => 真切
鼻祖 => 开山祖师
比比皆是 => 触目皆是
比方 => 比喻
比及 => 等到
比较 => 比拟
比力 => 较量
比量齐观 => 同等看待
比拟 => 比较
比年 => 频年
比年不登 => 岁比不登
比如 => 好比
比赛 => 竞赛
比岁不登 => 比年不登
比武 => 交手
比翼双飞 => 鸾凤和鸣
比喻 => 比方
彼苍 => 上苍
笔底生花 => 挥洒自如
笔耕墨耘 => 卖文为活
笔据 => 凭单
笔墨 => 文字
笔挺 => 笔直
笔直 => 笔挺
笔走龙蛇 => 鸾翔凤翥
鄙见 => 拙见
鄙俚 => 卑鄙
鄙吝 => 小器
鄙弃 => 唾弃
鄙人 => 不才
鄙视 => 小看
鄙俗 => 陋俗
鄙言 => 粗言
鄙谚 => 俚语
鄙意 => 愚见
必不得已 => 迫不得已
必定 => 一定
必恭必敬 => 恭恭敬敬
必然 => 必定
必须 => 必需
必需 => 必须
必要 => 需要
毕竟 => 究竟
毕命 => 死灭
毕生 => 终生
毕业 => 卒业
闭口 => 钳口
闭口无言 => 缄口无言
闭门不出 => 韬匮藏珠
闭门塞窦 => 关门落锁
闭门造车 => 凭空捏造
闭幕 => 终结
闭月羞花 => 花容月貌
庇护 => 卵翼
婢女 => 使女
敝宅 => 寒家
弊病 => 弊端
弊端 => 弊病
碧眼儿 => 白种人
避讳 => 避忌
避祸 => 逃难
避忌 => 避讳
避难 => 逃亡
避债 => 躲债
璧还 => 归赵
璧赵 => 璧还
边陲 => 边境
边幅 => 容貌
边疆 => 边境
边界 => 界限
边境 => 边疆
边沿 => 边缘
边缘 => 边沿
砭骨 => 刺骨
编辑 => 编纂
编录 => 辑录
编年 => 纪年
编削 => 删改
编纂 => 编辑
鞭策 => 鼓动
鞭笞 => 鞭挞
鞭挞 => 抨击
贬价 => 降价
弁急 => 遑急
弁冕 => 礼帽
弁言 => 引言
拚命 => 搏命
便函 => 私函
便利 => 方便
便是 => 就是
便条 => 条子
便宜 => 廉价
变成 => 酿成
变动 => 更改
变革 => 变更
变更 => 变革
变化 => 变更
变化多端 => 瞬息万变
变化无穷 => 变化多端
变幻 => 幻化
变节 => 叛变
变乱 => 事件
变态 => 失常
遍及 => 普及
遍体鳞伤 => 体无完肤
辨白 => 剖白
辨别 => 鉴别
辨认 => 识别
辩白 => 辩护
辩驳 => 回嘴
辩护 => 辩解
辩解 => 辩护
辩论 => 争辩
辩说 => 辩论
彪炳 => 特出
标记 => 标志
标题 => 题目
标语 => 口号
标志 => 标记
标致 => 美丽
标准 => 尺度
表白 => 剖明
表里 => 内外
表露 => 披露
表率 => 榜样
表面 => 外面
表明 => 注解
表情 => 脸色
表示 => 表现
表态 => 亮相
表现 => 表示
表扬 => 表彰
表彰 => 表扬
别出心裁 => 自出机杼
别的 => 其余
别号 => 别名
别开生面 => 另具匠心
别离 => 分袂
别名 => 别号
别史 => 野史
别无长物 => 一无长物
别析 => 剖判
宾客盈庭 => 三千珠履
宾朋迎门 => 宾朋盈门
宾朋盈门 => 高朋满座
摈除 => 撵走
摈弃 => 抛弃
冰壶秋月 => 光风霁月
冰冷 => 冰凉
冰脸 => 冷面
冰凉 => 冰冷
冰片 => 龙脑
冰清玉洁 => 不染纤尘
冰炭不洽 => 水火不容
兵变 => 叛乱
兵法 => 兵书
兵戈 => 干戈
兵舰 => 军舰
兵力 => 军力
兵马 => 戎马
兵器 => 武器
兵士 => 战士
兵书 => 兵法
兵凶战危 => 佳兵不祥
兵种 => 军种
禀赋 => 天赋
并且 => 而且
并日而食 => 草衣木食
病国殃民 => 祸国殃民
病愈 => 痊愈
摒挡 => 收拾
拨浪鼓 => 货郎鼓
拨弄 => 盘弄
波澜 => 波涛
波浪 => 海浪
波涛 => 波澜
波折 => 曲折
剥夺 => 褫夺
剥极必复 => 否极必泰
剥削 => 盘剥
伯仲 => 手足
驳斥 => 驳倒
驳倒 => 批驳
驳诘 => 诘难
勃然变色 => 怫然作色
舶来品 => 水货
博爱 => 泛爱
博得 => 赢得
博古通今 => 见闻广博
博识 => 精深
博学多才 => 宏儒硕学
博学多闻 => 博古通今
搏斗 => 格斗
搏命 => 拚命
薄材 => 绵力
薄命 => 苦命
薄暮 => 傍晚
薄弱 => 软弱
薄酌 => 菲酌
补偿 => 赔偿
补充 => 弥补
补救 => 解救
补葺 => 修缮
补贴 => 补助
补助 => 补贴
补缀 => 修理
哺养 => 哺育
哺育 => 哺养
捕获 => 捕捉
捕鱼 => 打鱼
捕捉 => 捕获
不安本分 => 不安分
不安分 => 不安本分
不安于室 => 红杏出墙
不便 => 未便
不睬 => 不理
不测 => 意外
不长进 => 不成材
不成才 => 不长进
不吃烟火食 => 不食人间烟火
不辞劳苦 => 不辞劳怨
不辞劳怨 => 不辞劳苦
不搭腔 => 不答腔
不搭嘴 => 不搭腔
不达时宜 => 不合时宜
不打不成相与 => 不打不相识
不打不相识 => 不打不成相与
不但 => 不只
不当 => 欠妥
不当准 => 不作准
不得要领 => 茫无头绪
不断 => 赓续
不对 => 纰谬
不夺农时 => 不违农时
不二 => 不贰
不贰 => 不二
不乏其人 => 不胜枚举
不法 => 造孽
不分高下 => 难分轩轾
不分皁白 => 不顾曲直
不敷 => 不足
不伏手 => 不顺手
不服水土 => 水土不服
不该 => 不应
不共戴天 => 誓不两立
不苟言笑 => 一本正经
不够 => 不敷
不顾 => 掉臂
不顾曲直 => 不分皁白
不顾外表 => 不拘小节
不顾一切 => 悍然不顾
不光 => 不但
不过 => 不外
不寒而栗 => 毛骨悚然
不好 => 欠好
不合错误 => 不对
不合时宜 => 不达时宜
不即不离 => 半推半就
不计其数 => 不可胜数
不佳 => 欠安
不见圭角 => 不露锋芒
不胫而走 => 风行一时
不拘小节 => 落拓不羁
不绝 => 不停
不刊之论 => 不易之论
不堪 => 不胜
不可 => 弗成
不可偻指算 => 更仆难数
不可胜数 => 数不胜数
不可思议 => 难以想象
不可一世 => 咄咄逼人
不克不及 => 不能
不肯 => 不愿
不郎不秀 => 不稂不莠
不稂不莠 => 不郎不秀
不劳而获 => 坐享其成
不理 => 不睬
不利 => 晦气
不料 => 不虞
不吝 => 不惜
不吝指教 => 不吝珠玉
不吝珠玉 => 不吝指教
不留神 => 不留心
不留心 => 不留神
不露锋芒 => 不露圭角
不露神色 => 不露声色
不露声色 => 不露神色
不伦不类 => 不正经
不论 => 岂论
不落窠臼 => 不落俗套
不落俗套 => 不落窠臼
不免 => 难免
不谋而合 => 不约而同
不能 => 不克不及
不能尽数 => 不能胜数
不能胜数 => 不能尽数
不能自已 => 不能自制
不能自制 => 不能自已
不宁不奈 => 不宁奈
不宁不耐 => 不宁耐
不宁奈 => 不宁不奈
不宁耐 => 不宁不耐
不平 => 不屈
不期而遇 => 萍水相逢
不求甚解 => 囫囵吞枣
不屈 => 不平
不屈不挠 => 再接再厉
不然 => 否则
不染纤尘 => 冰清玉洁
不入耳 => 不中听
不伤脾胃 => 惠而不费
不上不下 => 处境尴尬
不慎 => 失慎
不胜 => 不堪
不胜枚举 => 不乏其人
不省人事 => 昏迷不醒
不识时变 => 不识时务
不识时务 => 吃米不知米价
不识一丁 => 不识之无
不识之无 => 不识一丁
不食人间烟火 => 不吃烟火食
不守妇道 => 不安于位
不顺手 => 不伏手
不死即伤 => 非死即伤
不停 => 一直
不通 => 欠亨
不同 => 分歧
不妥 => 不当
不外 => 不过
不违农时 => 不夺农时
不唯 => 不惟
不惟 => 不唯
不问可知 => 不言而喻
不惜 => 不吝
不相上下 => 平起平坐
不相闻问 => 断绝往来
不消 => 不用
不行 => 不可
不学而能 => 生而知之
不雅 => 不雅观
不言而喻 => 不问可知
不厌其详 => 不厌求详
不厌求详 => 不厌其详
不要紧 => 没关系
不一 => 纷歧
不一而足 => 所在多有
不遗余力 => 竭尽全力
不以为意 => 漫不经心
不易之论 => 不刊之论
不意 => 不料
不翼而飞 => 不知去向
不应 => 不该
不用 => 不消
不由得 => 忍不住
不愿 => 不肯
不约而合 => 不谋而合
不正经 => 不伦不类
不知恩义 => 忘恩负义
不知去向 => 石沉大海
不值一提 => 何足道哉
不中听 => 不入耳
不准 => 禁绝
不足齿数 => 不足挂齿
不足挂齿 => 不足齿数
不足为据 => 不足为凭
不足为凭 => 不足为据
不足为奇 => 无独有偶
不作数 => 不当准
布掸子 => 拂尘
布道 => 传教
布告 => 书记
布鼓雷门 => 班门弄斧
布局 => 结构
布匹 => 布疋
布疋 => 布匹
布衣 => 平民
布衣交 => 贫贱交
布衣粝食 => 布衣蔬食
布衣蔬食 => 布衣粝食
布置 => 安排
步兵 => 步卒
步调 => 步骤
步队 => 队伍
步伐 => 措施
步辇儿 => 步行
步碾儿 => 步辇儿
步骤 => 步调
步卒 => 步兵
部队 => 军队
部分 => 部门
部门 => 部分
部署 => 安排
部下 => 手下
部属 => 下属
簿本 => 本子
猜忌 => 猜疑
猜拳 => 豁拳
猜想 => 料想
猜疑 => 猜忌
猜中 => 料中
才干 => 才华
才高八斗 => 学富五车
才华 => 才干
才能 => 能力
才气 => 才干
才情 => 才思
才思 => 才情
材伎 => 材艺
材料 => 资料
材艺 => 材伎
财宝 => 玉帛
财帛 => 钱财
财产 => 产业
财贿 => 财货
财货 => 财贿
财路 => 财源
财气 => 财运
财务 => 财政
财源 => 财路
财运 => 财气
财政 => 财务
裁缝 => 成衣
裁判员 => 评判员
裁人 => 裁员
裁员 => 裁人
采纳 => 采用
采取 => 采用
采用 => 采取
参半 => 各半
参加 => 加入
参见 => 拜见
参军 => 从军
参考之资 => 他山之石
参谋 => 顾问
参与 => 介入
残暴 => 残酷
残害 => 践踏糟踏
残酷 => 残暴
残虐 => 肆虐
残破 => 残缺
残缺 => 残破
残忍 => 残暴
残余 => 残存
惭愧 => 忸捏
惨白 => 苍白
惨恻 => 凄怆
惨怆 => 惨恻
惨淡 => 昏暗
灿烂 => 残暴
仓促 => 仓皇
仓皇 => 仓促
仓卒 => 匆急
伧夫俗人 => 凡夫俗子
沧海横流 => 祸乱滔天
沧海桑田 => 白云苍狗
沧海微尘 => 太仓一粟
沧海一粟 => 九牛一毫
苍白 => 惨白
苍翠 => 葱翠
苍茫 => 苍莽
苍莽 => 苍茫
苍头 => 厮役
操持 => 筹划
操心 => 费心
操行 => 品行
操纵 => 把持
嘈吵喧斗 => 哗闹
草率 => 轻率
草帽 => 凉帽
草木不生 => 牛山濯濯
草木皆兵 => 杯弓蛇影
草木惊心 => 惊弓之鸟
草拟 => 起草
草鞋 => 芒鞋
草野 => 草泽
草衣木食 => 并日而食
草泽 => 草野
草纸 => 厕纸
册本 => 书籍
册封 => 封爵
侧丽 => 侧艳
侧艳 => 侧丽
侧重 => 着重
厕所 => 茅厕
厕纸 => 草纸
恻隐 => 怜悯
测验 => 考试
测字 => 拆字
策划 => 谋划
策应 => 接应
岑寂 => 冷静
岑岭 => 高峰
层次 => 条理
查察 => 检察
查抄 => 搜查
查对 => 核对
查访 => 察访
查究 => 核办
查考 => 覆按
查问 => 盘问
查验 => 检验
茶话会 => 谈话会
茶楼 => 茶肆
茶青 => 墨绿
茶室 => 茶楼
察访 => 查访
察看 => 观察
察言观色 => 鉴貌辨色
差别 => 差异
差错 => 错误
差异 => 差别
拆伙 => 散伙
拆字 => 测字
柴炭 => 木炭
豺狼 => 虎豹
搀扶 => 扶持
搀和 => 搀杂
搀杂 => 夹杂
谗言 => 诽语
孱弱 => 羸弱
馋涎欲滴 => 垂涎欲滴
缠累 => 牵累
缠绵 => 缱绻
缠绕 => 环绕纠缠
蝉联 => 留任
产品 => 产物
产生 => 发生
产物 => 产品
产业 => 家当
谄媚 => 谄谀
谄谀 => 谄媚
铲除 => 革除
阐发 => 分析
阐明 => 说明
阐述 => 论述
忏悔 => 懊悔
颤动 => 颤抖
颤抖 => 发抖
猖 => 跋扈
猖獗 => 猖狂
猖狂 => 猖獗
长处 => 优点
长短不一 => 犬牙交错
长久 => 久长
长空 => 漫空
长眠 => 长逝
长命 => 龟龄
长命百岁 => 天保九如
长年 => 终年
长期 => 历久
长枪 => 蛇矛
长驱直入 => 当者披靡
长逝 => 长眠
长寿 => 长命
长途 => 远程
长袖善舞 => 多财善贾
长于 => 擅长
长吁 => 浩叹
长吁短叹 => 对天长叹
长远 => 久远
尝尝 => 试试
尝鼎一脔 => 见微知着
尝试 => 测验考试
偿还 => 了偿
常常 => 经常
常规 => 惯例
场合 => 场所
场合排场 => 局面
场面 => 排场
场所 => 场合
怅惋 => 怅惜
怅惘 => 惘然
怅惜 => 怅惋
畅快 => 酣畅
畅通 => 通顺
倡导 => 提倡
倡寮 => 妓院
唱本 => 曲稿
抄本 => 手本
抄录 => 抄写
抄掠 => 搜劫
抄袭 => 剽窃
抄写 => 缮写
超出 => 超越
超等 => 超级
超过 => 跨越
超过跨过 => 高出
超级 => 超等
超群出众 => 超群绝伦
超群绝伦 => 超群出众
超越 => 超出
巢毁卵破 => 唇亡齿寒
朝晨 => 清早
朝梁暮陈 => 朝梁暮晋
朝梁暮晋 => 朝梁暮陈
朝气 => 生气
朝秦暮楚 => 朝三暮四
朝三暮四 => 反复无常
朝上进步 => 进取
朝夕 => 旦夕
朝霞 => 早霞
朝阳 => 旭日
嘲笑 => 讥笑
潮流 => 潮水
潮水 => 潮流
吵架 => 打骂
吵骂 => 交谪
吵杂 => 烦吵
炒鱿鱼 => 卷铺盖
车费 => 车资
车水马龙 => 毂击肩摩
车资 => 车费
扯破 => 撕裂
扯谈 => 胡诌
彻里彻外 => 彻头彻尾
彻上彻下 => 彻里彻外
彻夜 => 通宵
撤除 => 除去
撤退 => 退却
撤消 => 取消
撤职 => 免职
澈底 => 透澈
澈底觉悟 => 大澈大悟
瞋目 => 怒目
尘寰 => 凡间
尘世 => 红尘
尘事 => 尘务
尘土 => 灰尘
尘务 => 尘事
沉寂 => 沉静
沉静 => 沉寂
沉痾 => 沉
沉沦 => 沉溺
沉迷 => 陷溺
沉湎 => 沉沦
沉默 => 缄默
沉溺 => 沉沦
沉溺堕落 => 沦落
沉思 => 寻思
沉重 => 繁重
沉着 => 镇静
沉醉 => 陶醉
陈腐 => 迂腐
陈规 => 成规
陈迹 => 痕迹
陈旧 => 陈腐
陈雷之契 => 管鲍之交
陈列 => 摆设
陈腔滥调 => 八股
陈设 => 摆设
陈述 => 陈说
陈说 => 陈述
陈诉 => 报告
晨光 => 晨曦
晨曦 => 晨光
衬托 => 陪衬
称孤道寡 => 称王称帝
称呼 => 称谓
称身 => 合身
称颂 => 称赞
称王称帝 => 称孤道寡
称谓 => 称呼
称心快意 => 遂心如愿
称赞 => 夸奖
趁便 => 顺便
趁火打劫 => 攻其不备
趁机 => 乘隙
趁热打铁 => 一气呵成
趁早 => 赶早
撑场面 => 充排场
瞠乎其后 => 望尘莫及
成仇 => 构怨
成功 => 胜利
成规 => 陈规
成果 => 结果
成绩 => 成就
成见 => 偏见
成就 => 造诣
成名术 => 登龙术
成品 => 制品
成群结队 => 三五成群
成仁取义 => 视死如归
成衣 => 裁缝
呈现 => 出现
承继 => 继承
承诺 => 许诺
承前启后 => 继往开来
承情 => 领情
承认 => 认可
承上启下 => 承先启后
承受 => 蒙受
承袭 => 承继
承先启后 => 承上启下
诚笃 => 诚实
诚惶诚恐 => 坐卧不安
诚恳 => 恳切
诚实 => 老实
诚心 => 诚恳
诚挚 => 真挚
城开不夜 => 金吾不禁
乘车 => 搭车
乘船 => 搭船
乘机 => 伺机
乘凉 => 纳凉
乘隙 => 趁机
乘虚而入 => 浑水摸鱼
惩办 => 惩处
惩罚 => 处分
惩治 => 惩办
程度 => 水平
程序 => 法式
吃法 => 服法
吃尽当光 => 罗掘俱穷
吃惊 => 受惊
吃苦俭朴 => 忍苦
吃素 => 食斋
笞打 => 楚挞
痴钝 => 迟钝
痴肥 => 臃肿
痴顽 => 愚钝
弛禁 => 开禁
弛刑 => 减刑
池塘 => 水池
池鱼之殃 => 无妄之灾
驰名 => 闻名
驰誉 => 驰名
迟钝 => 缓慢
迟缓 => 缓慢
迟疑 => 犹豫
持平立论 => 平心而谈
持续 => 连续
持疑不定 => 持疑不决
持疑不决 => 持疑不定
持志 => 守志
持重 => 稳重
尺牍 => 函牍
尺度 => 标准
齿豁头童 => 老态龙钟
耻辱 => 羞辱
耻笑 => 嘲笑
褫夺 => 剥夺
叱呵 => 叱喝
叱喝 => 叱呵
叱责 => 斥责
斥革 => 革退
斥候 => 标兵
斥骂 => 诃斥
斥责 => 叱责
赤忱 => 赤心
赤诚 => 耻辱
赤胆忠心 => 忠心耿耿
赤脚 => 光脚
赤军 => 红军
赤色 => 红色
赤身 => 裸体
赤身露体 => 袒裼裸裎
赤手空拳 => 手无寸铁
赤心 => 赤忱
饬厉 => 戒勉
炽热 => 灼热
翅膀 => 同党
充斥 => 充满
充当 => 充任
充分 => 充足
充公 => 没收
充饥 => 果腹
充军 => 放逐
充满 => 充斥
充排场 => 撑场面
充沛 => 充分
充任 => 充当
充实 => 充分
充数 => 凑数
充溢 => 充满
充裕 => 富余
充足 => 充分
冲动 => 激动
冲毁 => 冲垮
冲破 => 打破
冲刷 => 冲洗
冲洗 => 冲刷
冲撞 => 抵触触犯
憧憬 => 向往
虫鸣水沸 => 蜩螗沸羹
虫豸 => 昆虫
虫篆之技 => 雕虫小技
崇拜 => 崇敬
崇高 => 高尚
崇敬 => 崇拜
宠爱 => 溺爱
宠儿 => 骄子
宠姬 => 爱妾
宠任 => 宠信
宠辱祸福 => 生杀与夺
宠信 => 宠任
抽丰 => 打秋风
抽空 => 抽闲
抽泣 => 抽咽
抽闲 => 抽空
抽芽 => 萌芽
抽咽 => 抽泣
抽噎 => 抽泣
仇恨 => 痛恨
仇家 => 对头
仇人 => 敌人
仇视 => 敌视
惆怅 => 难过
愁肠百结 => 满腹忧愁
愁肠寸断 => 哀肠百转
愁眉不展 => 颦眉促额
愁眉苦脸 => 愁眉锁眼
愁闷 => 忧郁
愁云满面 => 愁眉不展
稠密 => 浓密
稠人广众 => 大庭广众
稠浊 => 混杂
筹办 => 筹备
筹备 => 准备
筹划 => 计划
筹谋 => 策划
筹议 => 筹商
踌躇 => 迟疑
雠正 => 厘正
丑恶 => 丑陋
丑陋 => 丑恶
臭名 => 污名
臭名远扬 => 臭名昭着
臭名昭着 => 名誉扫地
出版 => 出书
出场 => 进场
出错 => 失足
出尔反尔 => 言而无信
出发 => 动身
出发点 => 起点
出谷迁乔 => 乔迁之喜
出家 => 落发
出口成章 => 七步之才
出力异常 => 特别卖力
出漏洞 => 露马脚
出路 => 前途
出没无常 => 神出鬼没
出面 => 出头具名
出谋划策 => 出谋献策
出谋献策 => 出谋划策
出奇制胜 => 声东击西
出人意表 => 出人意料
出人意料 => 出人意表
出入 => 收支
出色 => 精彩
出身 => 出生
出神入化 => 炉火纯青
出生 => 出身
出生入死 => 南征北战
出声 => 作声
出世 => 降生
出书 => 出版
出头具名 => 出面
出息 => 前程
出现 => 涌现
出言如山 => 一言九鼎
出言无状 => 恶语伤人
初版 => 第一版
初创 => 始创
初次 => 首次
初赛 => 预赛
初月 => 眉月
初志 => 初衷
初衷 => 初志
除暴安良 => 吊民伐罪
除奸 => 锄奸
除旧布新 => 送旧迎新
除旧更新 => 革故鼎新
除夕 => 大年节
锄奸 => 除奸
储备 => 贮备
储藏 => 蕴藏
楚楚可怜 => 我见犹怜
楚切 => 悲凄
处罚 => 处分
处分 => 处罚
处境尴尬 => 不上不下
处理 => 处置
处女 => 童贞
处所 => 地方
处置 => 处理
处置惩罚 => 处理
触目皆是 => 比比皆是
触目惊心 => 惊心动魄
触怒 => 惹恼
矗立 => 耸立
揣测 => 忖度
揣摩 => 琢磨
啜泣 => 抽泣
穿房过屋 => 穿房入户
穿房入户 => 穿房过屋
穿着 => 穿戴
传播 => 流传
传布 => 传播
传达 => 转达
传记 => 列传
传教 => 布道
传染 => 沾染
传染病 => 流行症
传神 => 逼真
传授 => 教授
传闻 => 风闻
船埠 => 码头
船长 => 船主
船厂 => 船坞
船面 => 甲板
船坞 => 船厂
船主 => 船长
喘气 => 喘息
喘息 => 喘气
串通 => 通同
床上安床 => 迭床架屋
床头金尽 => 囊空如洗
创办 => 开办
创建 => 创立
创立 => 创建
创始 => 开创
创新 => 立异
创造 => 发明
吹糠见米 => 立竿见影
吹牛 => 吹法螺
吹捧 => 吹嘘
吹嘘 => 吹捧
炊事 => 伙食
垂垂 => 渐渐
垂怜 => 怜爱
垂纶 => 钓鱼
垂死 => 病笃
垂死挣扎 => 狗急跳墙
垂头丧气 => 没精打采
垂危 => 弥留
垂涎欲滴 => 馋涎欲滴
锤炼 => 锻炼
春风得意 => 喜气洋洋
春宫 => 秘戏图
春光 => 春景春色
春联 => 对联
春情 => 春心
春心 => 春情
纯粹 => 纯洁
纯洁 => 纯粹
纯熟 => 熟练
纯真 => 纯粹
纯正 => 纯粹
纯挚 => 纯真
唇亡齿寒 => 巢倾卵破
淳厚 => 浑厚
淳朴 => 浑厚
蠢蠢欲动 => 捋臂张拳
戳穿 => 揭穿
词采 => 词藻
词典 => 辞书
词翰 => 词章
词句 => 文句
词讼 => 刀笔
词藻 => 词华
词章 => 词翰
慈爱 => 慈祥
慈悲心肠 => 好生之德
慈祥 => 慈爱
辞官 => 去官
辞书 => 词典
辞职 => 告退
辞职归里 => 告老还乡
雌雄 => 牝牡
此生 => 今生
此中 => 其中
此中人 => 局内人
次第 => 次序递次
次货 => 劣货
次序 => 顺序
刺刺不休 => 唠唠叨叨
刺耳 => 逆耳
刺眼 => 刺目耀眼
赐予 => 赐赉
赐与 => 给予
从古到今 => 古往今来
从军 => 参军
从前 => 早年
从容 => 自在
从容不迫 => 不迟不疾
从容自若 => 从容自在
从容自在 => 从容自若
从速 => 赶快
从头到尾 => 从头至尾
从头至尾 => 从头到尾
从兄弟 => 堂兄弟
从属 => 附属
匆匆 => 促
匆促 => 仓促
匆忙 => 急忙
葱翠 => 苍翠
葱茏 => 葱郁
葱郁 => 葱茏
聪慧 => 聪明
聪明 => 聪慧
聪明一世 => 懵懂一时
聪颖 => 伶俐
丛聚 => 簇集
丛林 => 森林
凑集 => 聚集
凑数 => 充数
凑数其间 => 碌碌无为
粗暴 => 粗鲁
粗鄙 => 粗俗
粗糙 => 粗拙
粗鲁 => 粗暴
粗躯 => 贱躯
粗俗 => 粗鄙
粗言 => 鄙言
粗衣劣食 => 恶衣恶食
促进 => 增进
促膝谈心 => 把臂而谈
簇集 => 丛聚
簇拥 => 蜂拥
窜犯 => 窜扰
窜改 => 篡改
窜扰 => 窜犯
篡夺 => 夺取
篡改 => 改动
摧残浪费蹂躏 => 糟蹋
璀璨 => 残暴
脆而不坚 => 华而不实
脆弱 => 软弱
村落 => 村
村塾 => 村学
村学 => 村校
村庄 => 村落
村子 => 村庄
存案 => 备案
存放 => 寄存
存眷 => 关注
存身 => 藏身安身
存亡 => 生死
存心 => 居心
忖前思后 => 前思后想
寸晷 => 寸阴
寸心 => 寸衷
寸阴 => 寸晷
寸衷 => 寸心
磋商 => 商量
措施 => 办法
错爱 => 谬爱
错愕 => 惊惶
错漏 => 讹夺
错误 => 毛病
搭车 => 乘车
搭船 => 乘船
搭档 => 错误
搭架子 => 摆架子
搭客 => 乘客
搭钮 => 铰链
达成 => 杀青
达到 => 到达
答案 => 谜底
答复 => 回答
答理 => 理睬
答应 => 准许
答允 => 应承
打扮 => 装扮
打单 => 勒索
打倒 => 打垮
打定主意 => 拿定主意
打斗 => 斗殴
打赌 => 赌博
打盹 => 瞌睡
打更 => 击柝
打狗不看主人面 => 罔顾情面
打击 => 袭击
打饥荒 => 闹饥荒
打架 => 打斗
打搅 => 打扰
打劫 => 掠夺
打垮 => 打倒
打量 => 端详
打猎 => 狩猎
打骂 => 吵架
打门 => 叩门
打秋风 => 抽丰
打趣 => 玩笑
打扰 => 打搅
打扫 => 扫除
打手式 => 打手势
打手势 => 打手式
打水 => 取水
打顺风锣 => 打顺风旗
打顺风旗 => 打顺风锣
打算 => 盘算
打碎 => 打坏
打胎 => 人工流产
打听 => 探听
打通 => 买通
打消 => 消除
打眼号 => 递眼色
打仗 => 接触
大 => 年夜
大败 => 大北
大班 => 买办
大半 => 泰半
大北 => 大败
大材小用 => 牛鼎烹鸡
大肠告小肠 => 饥肠辘辘
大氅 => 斗篷
大澈大悟 => 澈底觉悟
大吹牛皮 => 大张其词
大胆 => 勇敢
大刀阔斧 => 大马金刀
大盗 => 悍贼
大德 => 盛德
大抵 => 约略
大发雷霆 => 怒形于色
大方 => 慷慨
大夫 => 医生
大富 => 豪富
大腹便便 => 脑满肠肥
大概 => 也许
大纲 => 纲目
大哥 => 年老
大公无私 => 为国损躯
大公至正 => 堂堂正正
大喊 => 大呼
大亨 => 富翁
大呼 => 大叫
大话 => 诳言
大惑不解 => 百思不解
大家 => 人人
大奸 => 巨猾
大将 => 上将
大进 => 猛进
大快人心 => 民怨沸腾
大力 => 鼎力
大力成全 => 鼎力玉成
大量 => 大批
大路 => 亨衢
大略 => 简略
大名 => 台甫
大名鼎鼎 => 赫赫有名
大模大样 => 高视阔步气宇轩昂
大难 => 浩劫
大难不死 => 劫后余生
大年夜 => 除夜
大怒 => 盛怒
大批 => 大量
大权独揽 => 大权在握
大煞风景 => 焚琴煮鹤
大声 => 高声
大师 => 巨匠
大水 => 洪水
大肆 => 鼎力大举
大肆咆哮 => 怒不可遏
大庭广众 => 众目睽睽
大喜过望 => 喜出望外
大相径庭 => 天差地别
大小 => 巨细
大言 => 狂言
大言不惭 => 大吹牛皮
大要 => 概略
大雨滂沱 => 大雨如注
大雨如注 => 大雨滂沱
大贼 => 剧盗
大札 => 华翰
大张旗鼓 => 重振旗鼓
大志 => 洪志
大智若愚 => 深藏若虚
大众 => 民众
大众化 => 普通化
大众文学 => 民间文学
大宗 => 大批
大族 => 富家
大醉 => 烂醉陶醉
大作 => 鸿文
呆板 => 死板
呆笨 => 愚拙
呆滞 => 凝滞
呆子 => 白痴
歹徒 => 暴徒
歹徒横行 => 恶人得势
代价 => 价值
代劳 => 代庖
代理 => 署理
代庖 => 代劳
代替 => 取代
带领 => 率领
待价而沽 => 奇货可居
怠惰 => 懒惰
怠倦 => 疲乏
逮捕 => 拘捕
戴德 => 感恩
丹成相许 => 披肝沥胆
丹诚相许 => 沥胆披肝
丹青妙手 => 美术大师
丹心 => 赤忱
单薄 => 薄弱
单纯 => 纯真
单刀赴会 => 孤军作战
单刀直入 => 刀刀见血
单独 => 零丁
单方面 => 片面
单人独马 => 匹马单枪
单身 => 独身只身
单位 => 单元
单元 => 单位
单子 => 票据
担当 => 担负
担负 => 担当
担任 => 担负
担水 => 挑水
担心 => 担忧
担忧 => 担心
耽搁 => 耽误
耽误 => 延误
殚精竭虑 => 殚智竭力
胆大如斗 => 泼天大胆
胆大妄为 => 轻举妄动
胆大心细 => 胆大心小
胆大心小 => 胆大心细
胆量 => 胆子
胆怯 => 恐惧
胆小 => 怯弱
胆小如鼠 => 小心谨慎
胆战心惊 => 提心吊胆
胆子 => 胆量
旦角 => 花旦
旦夕 => 夙夜迟早
但是 => 然则
诞辰 => 生日
诞生 => 出生
弹琴 => 抚琴
弹丸之地 => 立锥之地
弹压 => 镇压
淡泊 => 恬澹
淡薄 => 淡漠
淡漠 => 淡薄
淡色 => 浅色
蛋白 => 卵白
澹泊 => 恬淡
当兵 => 投军
当场 => 就地
当代 => 现代
当地 => 本地
当机不断 => 迟疑不决
当机立断 => 应机立断
当局 => 政府
当面错过 => 失之交臂
当年 => 昔时
当铺 => 寺库
当仁不让 => 义无反顾
当时 => 其时
当头棒喝 => 当头一棒
当头一棒 => 当头棒喝
当心 => 小心
当选 => 被选
当者披靡 => 势不可当
当中 => 傍边
当作 => 看成
挡住 => 盖住
党魁 => 党首
党首 => 党魁
党羽 => 翅膀
荡垢涤污 => 伐毛洗髓
荡气回肠 => 勾魂摄魄
荡瑕涤秽 => 除污去垢
荡漾 => 涟漪
荡舟 => 划船
荡子 => 浪子
档册 => 檀案
刀笔 => 词讼
刀刀见血 => 一针见血
刀光剑影 => 刀光血影
刀光血影 => 刀光剑影
刀口上舔血 => 刀头舔血
刀切斧砍 => 直截了当
刀头舔血 => 刀口上舔血
刀头之蜜 => 佛口蛇心
叨教 => 请问
叨在知己 => 忝在爱末
导引 => 扶引
倒背如流 => 滚瓜烂熟
倒持泰阿 => 授人以柄
倒霉 => 不利
倒是 => 却是
倒塌 => 坍毁
倒映 => 反照
捣蛋 => 捣鬼
捣鬼 => 捣乱
捣乱 => 扰乱
祷告 => 祈祷
到差 => 赴任
到场 => 参预
到处 => 随处
到处奔跑 => 东奔西走
到处奔走 => 仆仆风尘
到处颂扬 => 脍炙人口
到处为家 => 四海为家
到达 => 达到
到家 => 抵家
到临 => 莅临
悼念 => 吊唁
盗匪 => 伏莽
盗汗 => 冷汗
盗窟 => 山寨
盗魁 => 盗首
盗窃 => 偷盗
盗取 => 窃取
盗首 => 盗魁
盗贼 => 响马
盗贼四起 => 萑苻不靖
道贺 => 道喜
道理 => 事理
道路 => 途径
道貌岸然 => 不苟言笑
道歉 => 报歉
道听涂说 => 耳食之闻
道喜 => 道贺
道谢 => 叩谢
道学味 => 方巾气
得病 => 抱病
得偿所愿 => 心满意足
得寸进尺 => 软土深掘
得当 => 适合
得到 => 获得
得过且过 => 苟且偷生
得救 => 解围
得陇望蜀 => 贪心不足
得胜 => 获胜
得手 => 到手
得心应手 => 轻车熟路
得意 => 自得
得意洋洋 => 自鸣得意
得罪 => 冒犯
德高望重 => 年高德劭
德律风 => 电话
德配 => 元配
德威并用 => 剿抚兼施
德行 => 德性
的确 => 切实其实
的一确二 => 丁一卯二
灯胆 => 灯泡
灯号 => 暗记
灯红酒绿 => 醉生梦死
灯火辉煌 => 火树银花
灯泡 => 灯胆
灯芯 => 灯炷
灯烛辉煌 => 灯火辉煌
灯炷 => 灯芯
登岸 => 登陆
登基 => 即位
登记 => 挂号
登科 => 录取
登龙术 => 成名术
登陆 => 上岸
登山 => 爬山
登位 => 登基
登仙 => 尸解
登载 => 刊登
等待 => 期待
等到 => 比及
等候 => 等待
等级 => 品级
等量齐观 => 一视同仁
邓通之财 => 陶猗之富
瞪眼 => 怒视
低沉 => 消沉
低级 => 初级
低贱 => 卑贱
低劣 => 拙劣
低落 => 降低
低首下心 => 低头屈膝
低头 => 垂头
低微 => 卑微
滴水不漏 => 点水不漏
滴下 => 淌下
敌人 => 仇敌
敌视 => 仇视
敌手 => 对手
嫡 => 明日
嫡妻 => 发妻
嫡亲 => 至亲
嫡系 => 直系
诋毁 => 毁谤
底本 => 原本
底稿 => 稿本
底细 => 内情
底子 => 基础底细
抵触 => 抵牾
抵挡 => 招架
抵家 => 到家
抵抗 => 抵御
抵赖 => 狡赖
抵牾 => 抵触
抵押 => 典质
抵御 => 抵抗
砥柱中流 => 擎天一柱
地步 => 田地
地点 => 所在
地动 => 地震
地方 => 处所
地方不宁 => 盗贼四起
地方官 => 父母官
地府 => 九泉
地理 => 地舆
地利人和 => 人地相宜
地盘 => 地皮
地皮 => 土地
地痞 => 泼皮
地契 => 方单
地区 => 地域
地位 => 位置
地域 => 地区
地震 => 地动
地主 => 田主
弟妇 => 弟媳
弟媳 => 弟妇
弟子 => 门生
递眼色 => 打眼号
第三者 => 圈外人
第宅 => 私邸
谛视 => 凝视
谛听 => 倾听
缔盟 => 结盟
缔造 => 创作发明
颠簸 => 波动
颠倒 => 倒置
颠倒黑白 => 指鹿为马
颠峰 => 极峰
颠覆 => 推翻
颠末 => 经过
颠沛流离 => 流离转徙
颠三倒四 => 语无伦次
典范 => 范例
典丽矞皇 => 典雅堂皇
典型 => 典范
典押铺 => 解当铺
典雅堂皇 => 典丽矞皇
点窜 => 改削
点火 => 焚烧
点水不漏 => 滴水不漏
点头 => 颔首
点头答应 => 颔首应承
点缀 => 装点
电话 => 德律风
电扇 => 风扇
电影 => 片子
佃户 => 田户
店保 => 铺保
店铺 => 商号
店肆 => 店铺
店员 => 伙计
店主 => 雇主
玷辱 => 玷污
玷污 => 玷辱
惦记 => 惦念
惦念 => 想念
奠定 => 奠基
奠基 => 奠定
刁悍 => 强悍
刁滑 => 滑头
刁话 => 蛮话
刁狡 => 机诈
凋零 => 凋落
凋落 => 凋零
凋谢 => 凋零
雕虫小技 => 虫篆之技
雕刻 => 镌刻
雕栏 => 栏杆
雕零 => 雕落
雕落 => 雕零
雕琢 => 砥砺
吊儿郎当 => 游手好闲
吊颈 => 上吊
吊民伐罪 => 除暴安良
吊丧 => 吊问
吊唁 => 悼念
钓饵 => 诱饵
钓鱼 => 垂纶
调班 => 换班
调兵遣将 => 兴师动众
调查 => 查询拜访
调处 => 调解
调度 => 调剂
调和 => 折衷
调换 => 更换
调集 => 召集
调剂 => 调解
调解 => 调剂
调侃 => 奚弄
调理 => 疗养
调派 => 派遣
调皮 => 油滑
调停 => 调处
调养 => 保养
调用 => 挪用
调整 => 调剂
调治 => 调理
掉 => 失落
掉臂 => 不顾
掉队 => 落伍
跌宕 => 跌荡放诞
跌宕放诞 => 跌荡
跌荡 => 跌宕放诞
跌倒 => 摔倒
跌价 => 削价
迭床架屋 => 床上安床
谍报 => 情报
喋不休 => 咕哝不已
蹀躞 => 踥蹀
丁宁 => 打发
丁一卯二 => 的一确二
丁忧 => 母丧
叮咛 => 丁宁
叮嘱 => 吩咐
钉扣子 => 缝扣子
顶点 => 极点
顶峰 => 巅峰
顶撞 => 顶嘴
鼎力大举 => 大力
鼎力玉成 => 大力成全
鼎立 => 鼎峙
鼎新 => 更始
鼎足之势 => 三足鼎立
鼎祚 => 国祚
订定 => 制定
订婚 => 定亲
订价 => 定价
订盟 => 缔盟
订正 => 校勘
定都 => 建都
定夺 => 决议确定
定规 => 定例
定价 => 订价
定居 => 假寓
定例 => 定规
定名 => 命名
定命 => 天命
定期 => 按期
定胜败 => 分高下
定时 => 准时
定数 => 定命
定义 => 界说
定则 => 定章
定章 => 定则
定罪 => 入罪
丢魂失魄 => 失魂落魄
丢脸 => 难看
丢失 => 丧失
东奔西走 => 到处奔跑
东床 => 半子
东倒西歪 => 七颠八倒
东风 => 春风
东家 => 店主
东山再起 => 死灰复然
东西 => 器械
东洋 => 东瀛
东瀛 => 东洋
冬烘 => 腐儒
冬眠 => 蛰伏
冬衣 => 寒衣
懂得 => 理解
动机 => 念头
动乱 => 骚乱
动怒 => 起火
动人 => 动听
动人肺腑 => 感人心曲
动身 => 出发
动手 => 着手
动听 => 动人
动摇 => 摇动
动员 => 发动
动辄得咎 => 跋前踬后
恫吓 => 恐吓
洞开 => 敞开
洞若观火 => 了如指掌
洞穴 => 窟窿
洞烛奸邪 => 明镜高悬
都城 => 首都
都会 => 都邑
都门 => 毂下
都市 => 都会
都雅 => 雅观
兜售 => 兜销
兜销 => 兜售
斗极 => 北斗
斗南一人 => 旷世一人
斗篷 => 大氅
斗争 => 奋斗
斗志昂扬 => 意气风发
抖动 => 发抖
抖擞 => 焕发
抖擞精神 => 磨砺以须
陡峭 => 峻峭
豆浆 => 豆乳
豆蔻年华 => 及笄年华
豆剖瓜分 => 半壁江山
豆乳 => 豆浆
逗留 => 勾留
督工 => 监工
毒害 => 迫害
毒辣 => 狠毒
读书 => 念书
渎职 => 失职
独裁 => 专制
独断 => 专断
独断专行 => 一意孤行
独居 => 茕居
独立 => 自力
独木难支 => 孤掌难鸣
独特 => 奇特
独享权益 => 利益均沾
独一无二 => 举世无双
独占 => 独有
独占鳌头 => 夺得冠军
笃信 => 深信
笃志 => 埋头
堵截 => 切断
赌博 => 赌钱
赌气 => 负气
赌钱 => 打赌
赌咒 => 发誓
妒忌 => 嫉妒
杜康 => 狂药
杜门不出 => 闭门不出
杜撰 => 诬捏
度过 => 渡过
度量 => 器量
度日 => 过活
渡过 => 度过
渡水 => 涉水
端赖 => 全靠
端倪 => 眉目
端详 => 打量
端正 => 正直
端住 => 捧住
端庄 => 庄重
端坐 => 危坐
短命 => 夭折
短缺 => 缺乏
短寿 => 短折
断定 => 判断
断港绝潢 => 走投无路
断交 => 决绝
断绝 => 拒却
断绝往来 => 不相闻问
断命 => 毕命
断念 => 死心
断气 => 气绝
断然 => 决然毅然
断送 => 葬送
锻练 => 教练
锻炼 => 锤炼
堆积 => 聚积
堆栈 => 客栈
队伍 => 部队
对比 => 比较
对待 => 看待
对调 => 对换
对付 => 对于
对换 => 对调
对抗 => 反抗
对立 => 对峙
对联 => 春联
对手 => 敌手
对天长叹 => 长吁短叹
对头 => 仇人
对弈 => 棋战
对照 => 对比
对折 => 半数
对证 => 对质
对症下药 => 有的放矢
对质 => 对证
对峙 => 对立
对准 => 瞄准
敦促 => 催促
敦厚 => 敦朴
敦睦 => 亲善
敦朴 => 老诚
囤积居奇 => 待价而沽
顿脚 => 跺脚
顿时 => 马上
顿首 => 稽首
遁词 => 饰词
遁迹 => 避难
遁世 => 豹隐
多财善贾 => 长袖善舞
多此一举 => 画蛇添足
多么 => 何等
多难 => 多灾
多如牛毛 => 不可偻指算
多少 => 若干
多事生非 => 好管闲事
多事之秋 => 艰屯之际
多数 => 多半
多余 => 过剩
咄咄逼人 => 不可一世
哆嗦 => 发抖
夺目 => 醒目
夺取 => 牟取
夺职 => 免职
躲避 => 回避
躲藏 => 潜藏
躲债 => 避债
堕泪 => 流泪
堕落 => 腐化
舵手 => 梢公
跺脚 => 顿脚
讹诈 => 敲诈
扼杀 => 抹杀
扼守 => 把守
扼要 => 简要
恶毒 => 狠毒
恶搞 => 恶搞
恶妻 => 泼妇
恶人得势 => 歹徒横行
恶行 => 罪行
恶性难改 => 怙恶不悛
恶衣恶食 => 粗衣劣食
恶语伤人 => 出言无状
恶运 => 厄运
恶兆 => 凶兆
恶浊 => 肮脏
遏恶扬善 => 隐恶扬善
噩梦 => 恶梦
恩仇 => 恩怨
恩德 => 恩义
恩典 => 恩惠
恩惠 => 恩情
恩情 => 恩惠
恩怨 => 恩仇
恩泽 => 恩惠膏泽
而后 => 尔后
而且 => 并且
而已 => 罢了
尔后 => 而后
尔虞我诈 => 离心离德
耳环 => 耳饰
耳食之闻 => 道听涂说
耳饰 => 耳环
耳语 => 私语
迩来 => 近来
二八佳人 => 妙龄少女
二心 => 他心
贰言 => 异议
发表 => 揭橥
发兵 => 兴师
发布 => 宣布
发财 => 发家
发草帖 => 八字帖
发达 => 蓬勃
发动 => 动员
发抖 => 颤抖
发奋 => 奋发
发奋图强 => 自强不息
发愤 => 奋发
发疯 => 发狂
发号布令 => 发号令
发号令 => 发号施令
发号施令 => 发号出令
发话器 => 话筒
发慌 => 发窘
发挥 => 施展
发回 => 发还
发火点 => 起火点
发迹 => 起家
发急 => 着急
发酒疯 => 撒酒疯
发觉 => 觉察
发掘 => 挖掘
发狂 => 发疯
发蒙 => 启蒙
发明 => 创造
发难 => 起事
发妻 => 正室
发起 => 提议
发热 => 发烧
发轫 => 发端
发生 => 产生
发誓 => 起誓
发现 => 发明
发笑 => 失笑
发行 => 刊行
发芽 => 抽芽
发言 => 谈话
发展 => 成长
发作 => 发生发火
伐鼓 => 击鼓
伐毛洗髓 => 荡垢涤污
伐木 => 砍木
法规 => 律例
法纪 => 纲纪
法例 => 法规
法律 => 司法
法门 => 秘诀
法式 => 轨范
法术 => 术数
法网恢恢 => 天网恢恢
法眼 => 高眼
法衣 => 僧衣
法则 => 轨则
法子 => 方法
珐琅 => 搪瓷
帆船 => 风帆
帆海 => 航海
帆樯 => 桅竿
帆柱 => 帆樯
番薯 => 甘薯
翻滚 => 翻腾
翻江倒海 => 排山倒海
翻开 => 掀开
翻戏 => 老千
翻译员 => 传译员
凡夫俗子 => 伧夫俗人
凡间 => 世间
凡人 => 常人
烦吵 => 吵杂
烦闷 => 抑郁
烦懑 => 不快
烦恼 => 懊恼
烦躁 => 焦躁
樊笼 => 牢笼
蕃殖 => 繁生
繁华 => 繁荣
繁忙 => 忙碌
繁荣 => 繁华
繁荣昌盛 => 繁荣富强
繁荣富强 => 繁荣昌盛
繁生 => 蕃殖
繁盛 => 闹热
繁芜 => 庞杂
繁言吝啬 => 尖酸刻薄
繁杂 => 复杂
繁殖 => 滋生
繁重 => 沉重
反宾为主 => 太阿倒持
反驳 => 辩驳
反冲力 => 后坐力
反对 => 否决
反复 => 重复
反复无常 => 反复不定
反攻 => 抨击
反击 => 回击
反抗 => 对抗
反客为主 => 反宾为主
反老回童 => 回复青春
反面 => 不和
反目 => 交恶
反叛 => 反水
反省 => 检查
反水 => 反叛
反水不收 => 泼水难收
反响 => 反应
反应 => 反响
反映 => 反应
反照 => 倒映
反正 => 横竖
反转展转 => 回转
返国 => 回国
返来 => 回来离去
返梢 => 回销
犯得上 => 犯得着
犯得着 => 犯的上
犯法 => 犯罪
犯讳 => 犯忌
犯忌 => 犯讳
犯境 => 入寇
犯人 => 罪人
犯上作乱 => 图为不轨
犯罪 => 犯法
泛爱 => 博爱
泛论 => 总论
饭店 => 饭铺
饭馆 => 饭店
饭桶 => 脓包
范畴 => 领域
范例 => 典范
范围 => 规模
贩卖 => 销售
贩子 => 商人
梵衲 => 沙门
梵学 => 佛学
梵宇 => 佛寺
方案 => 计划
方便 => 便利
方才 => 刚刚
方寸已乱 => 心慌意乱
方单 => 地契
方法 => 办法
方剂 => 方子
方巾气 => 道学味
方士 => 术士
方式 => 方法
方向 => 偏向
方兴未艾 => 旭日东升
方丈 => 住持
方丈和尚 => 当家和尚
方正 => 朴直
方子 => 方剂
芳华 => 青春
芳香 => 芬芳
芳泽 => 芗泽
防备 => 戒备
防地 => 防线
防范 => 防备
防患未然 => 有备无患
防守 => 戍守
防线 => 防地
妨碍 => 妨害
妨害 => 妨碍
房东 => 房主
房客 => 佃农
房屋 => 衡宇
仿造 => 仿制
仿照 => 模仿
仿制 => 仿造
访候 => 拜望
访拿 => 跴缉
访问 => 拜访
彷佛 => 似乎
彷徨 => 徘徊
彷徨歧途 => 徘徊歧路
放荡 => 放纵
放荡不羁 => 放荡任气
放工 => 下班
放开 => 摊开
放弃 => 废弃
放晴 => 转晴
放手 => 撒手
放肆 => 放纵
放肆荒唐 => 胡天胡地
放下屠刀 => 痛改前非
放心 => 宁神
放学 => 下学
放言高论 => 夸夸其言
放洋 => 出洋
放逐 => 流放
放纵 => 放肆
飞奔 => 飞驰
飞必冲天 => 平地一声雷
飞驰 => 飞奔
飞短流长 => 流言蜚语
飞腾 => 高涨
飞舞 => 飘动
飞翔 => 飞行
飞行 => 飞翔
飞扬跋扈 => 作威作福
非常 => 异常
非法 => 不法
非凡 => 不凡
非命 => 横死
非难 => 谴责
非死即伤 => 不死即伤
菲薄 => 微薄
菲林 => 胶卷
菲仪 => 菲敬
菲酌 => 薄酌
蜚言 => 浮言
肥沃 => 肥饶
肥皂 => 番笕
匪贼 => 强盗
诽谤 => 毁谤
诽语 => 谗言
吠影吠声 => 随声附和
废除 => 破除
废弃 => 放弃
废物 => 废料
废止 => 废除
沸水 => 滚水
费尽唇舌 => 舌敝唇焦
费尽心机 => 想方设法
费尽心血 => 挖空心思
费力 => 辛苦
费钱 => 花钱
费神 => 费心
费心 => 操心
分崩离析 => 支离破碎
分辨 => 分辩
分辨差别 => 分别辨别
分辩 => 分辨
分别 => 分离
分别辨别 => 分辨差别
分布 => 散布
分担 => 分管
分高下 => 决雌雄
分割 => 朋分
分管 => 分担
分家 => 分居
分解 => 分化
分居 => 分家
分开 => 离开
分离 => 分别
分列 => 排列
分裂 => 决裂
分泌 => 排泄
分娩 => 临蓐
分派 => 分配
分配 => 分派
分歧 => 不合
分散 => 疏散
分身 => 两全
分身不暇 => 分身乏术
分身乏术 => 分身不暇
分手 => 分别
分说 => 分辩
分外 => 特别
分析 => 剖析
吩咐 => 嘱咐
纷繁 => 纷纷
纷纷 => 纷纭
纷乱 => 缭乱
纷歧 => 不一
纷纭 => 纷纷
纷至沓来 => 接踵而至
芬芳 => 芳香
氛围 => 气氛
坟场 => 墓地
焚膏继晷 => 通宵达旦
焚劫 => 焚掠
焚掠 => 焚劫
焚琴煮鹤 => 大煞风景
粉墨登场 => 袍笏登场
粉身碎骨奋不顾身 => 肝脑涂地
粉饰 => 掩饰
粉碎 => 破碎摧毁
奋不顾身 => 不屈不挠
奋斗 => 斗争
奋发 => 发奋
奋发蹈厉 => 奋发自强
奋发图强 => 奋发向上
奋起直追 => 迎头赶上
奋勇当先 => 奋勇争先
奋勇争先 => 奋勇当先
愤恨 => 恼恨
愤懑 => 怫郁
愤怒 => 恼怒
丰采 => 神姿
丰产 => 丰收
丰登 => 丰收
丰度 => 品貌
丰富 => 丰硕
丰厚 => 丰富
丰满 => 饱满
丰年 => 熟年
丰盛 => 丰富
丰收 => 丰产
丰硕 => 丰富
丰衣足食 => 人给家足
丰裕 => 充盈
风波 => 风浪
风采 => 风度
风尘仆仆 => 露宿风餐
风度 => 风姿
风度翩翩 => 风姿潇洒
风帆 => 帆船
风范 => 风仪
风格 => 作风
风景 => 景致
风静 => 风止
风浪 => 风波
风凉 => 凉快
风马不接 => 风马牛不相及
风马牛不相及 => 风马牛不相干
风靡云涌 => 风靡云蒸
风靡云蒸 => 风靡云涌
风平浪静 => 河清海晏
风起云涌 => 如火如荼
风气 => 风尚
风趣 => 幽默
风骚 => 风流
风扇 => 电扇
风尚 => 风气
风俗 => 风气
风闻 => 传闻
风物 => 风景
风行 => 盛行
风行一时 => 不胫而走
风雅 => 精致
风言风语 => 飞短流长
风雨飘摇 => 摇摇欲坠
风雨同舟 => 和衷共济
风韵 => 风度
风止 => 风静
风致 => 品格
风姿 => 风度
风姿潇洒 => 风度翩翩
封闭 => 关闭
封爵 => 册封
疯狂 => 猖狂
烽火 => 狼烟
锋利 => 锐利
蜂拥 => 簇拥
逢场作戏 => 偶一为之
逢迎 => 迎合
缝扣子 => 钉扣子
缝隙 => 裂缝
讽刺 => 讥讽
奉承 => 阿谀
奉告 => 告诉
奉命 => 衔命
奉劝 => 劝告
奉上 => 送上
奉送 => 赠送
奉养 => 伺候
奉迎 => 凑趣儿
佛教 => 释教
佛口蛇心 => 刀头之蜜
佛寺 => 梵宇
佛学 => 梵学
否定 => 否认
否极必泰 => 剥极必复
否极泰来 => 枯木逢春
否认 => 否定
否则 => 不然
夫唱妇随 => 鹿车共挽
夫妇 => 伉俪
夫君 => 外子
夫役 => 挑夫
肤见 => 浅见
肤浅 => 浮浅
敷衍 => 搪塞
敷衍了事 => 马马虎虎
伏法 => 受刑
伏枥老骥 => 归隐志士
伏莽 => 盗匪
伏祈 => 伏乞
伏乞 => 伏祈
伏羲 => 宓羲
伏诛 => 伏法
伏罪 => 服罪
扶持 => 搀扶
扶养 => 供养
扶摇直上 => 青云直上
扶引 => 导引
扶植 => 培植
扶助 => 扶直
怫然作色 => 勃然变色
拂尘 => 接风
拂面 => 掠面
拂晓 => 破晓
拂袖 => 拂衣
拂衣 => 拂袖
服从 => 屈服
服法 => 吃法
服侍 => 奉养
服务 => 办事
服膺 => 谨记
服罪 => 伏罪
浮薄 => 佻达
浮光掠影 => 走马看花
浮滑 => 轻狂
浮家泛宅 => 水上人家
浮夸 => 夸张
浮名 => 虚名
浮皮蹭痒 => 浮皮潦草
浮皮潦草 => 浮皮蹭痒
浮浅 => 肤浅
浮水衣 => 救生衣
浮图 => 宝塔
浮现 => 显现
浮言 => 蜚言
浮躁 => 急躁
符合 => 相符
福分 => 福气
福气 => 福泽
福寿膏 => 阿芙蓉
福寿绵长 => 福寿绵绵
福寿绵绵 => 福寿无疆
抚躬自问 => 扪心自问
抚摸 => 抚摩
抚琴 => 操琴
抚玩 => 赏玩
抚慰 => 安慰
抚心 => 扪心
抚养 => 抚育
抚育 => 抚养
府上 => 尊府
拊膺切齿 => 怒气冲天
斧正 => 示正
俯拾地芥 => 如拾草芥
俯仰由人 => 仰人鼻息
釜中游鱼 => 釜中之鱼
釜中之鱼 => 釜中游鱼
辅导 => 指点
辅音 => 子音
辅助 => 帮助
腐败 => 腐烂
腐化 => 腐蚀
腐烂 => 糜烂
腐儒 => 冬烘
腐蚀 => 腐化
腐朽 => 腐败
父（母）丧 => 丁忧
父老 => 长者
父母 => 怙恃
父母官 => 地方官
父执 => 世伯
付出 => 支付
付托 => 吩咐
付与 => 授予
付之一笑 => 一笑置之
付梓 => 排印
负担 => 累赘
负疚 => 抱歉
负气 => 赌气
负伤 => 挂花
负心 => 亏心
负薪救火 => 扬汤止沸
负约 => 误期
负债 => 欠债
附和 => 赞同
附近 => 邻近
附属 => 从属
复活 => 回生
复生 => 回生
复书 => 回信
复苏 => 苏醒
复习 => 温习
复兴 => 中兴
复原 => 回复复兴
复杂 => 庞杂
赴任 => 履新
赴汤蹈火 => 历尽艰险
副角 => 配角
富贵荣华 => 功名利禄
富厚 => 丰富
富家 => 巨室
富可敌国 => 金玉满堂
富丽 => 华丽
富强 => 强盛
富饶 => 富裕
富商 => 殷商
富翁 => 财主
富余 => 充裕
富裕 => 充裕
富足 => 充裕
赋税 => 钱粮
赋闲 => 失业
赋予 => 付与
覆按 => 查考
覆盖 => 笼罩
覆水难收 => 反水不收
覆信 => 回音
该当 => 应当
该死 => 活该
改扮 => 乔妆
改变 => 转变
改变主张 => 回心转意
改定 => 刊定
改动 => 修改
改革 => 改造
改过 => 悛改
改过自新 => 洗心革面
改换 => 更换
改进 => 改良
改良 => 改进
改名 => 更名
改善 => 改良
改弦易辙 => 改变方式
改邪归正 => 放下屠刀
改造 => 改革
改正 => 纠正
盖世太保 => 秘密警察
盖印 => 盖章
盖章 => 盖印
概括 => 归纳综合
干瘪 => 憔悴
干脆 => 爽性
干脆爽快 => 快人快事
干涸 => 干枯
干劲 => 劲头
干净 => 清洁
干枯 => 干涸
干练 => 老练
干娘 => 乳母
干涉 => 干预
干瘦 => 干瘪
干系 => 相干
干预 => 干涉
干预干与 => 干涉
干证 => 旁证
甘霖 => 甘雨
甘薯 => 番薯
甘心 => 情愿
甘雨 => 甘霖
甘愿 => 情愿
甘愿宁可 => 甘心
肝胆相照 => 肝胆照人
肝火 => 怒气
尴尬 => 为难
尴尬刁难 => 作对
赶快 => 赶紧
赶早 => 及早
感触 => 感想
感导 => 陶染
感到 => 觉得
感德 => 戴德
感动 => 激动
感恩图报 => 结草衔环
感化 => 浸染
感激 => 感谢
感激不尽 => 感激涕零
感激涕零 => 感激不尽
感觉 => 感到
感慨 => 感叹
感愧并交 => 感愧交集
感愧交集 => 感愧并交
感冒 => 伤风
感情 => 情感
感染 => 沾染
感人 => 动人
感受 => 感触感染
感叹 => 感慨
感想 => 感触
感谢 => 感激
刚才 => 适才
刚刚 => 方才
刚强 => 坚强
刚巧 => 适值
刚毅 => 坚毅
刚正 => 坚毅刚烈
岗亭 => 岗位
岗位 => 岗亭
纲纪 => 法纪
纲领 => 纲要
纲要 => 纲领
港口 => 口岸
皋比 => 虎皮
高昂 => 昂扬
高傲 => 清高
高超 => 高明
高潮 => 热潮
高出 => 凌驾
高大 => 嵬峨
高档 => 高级
高等 => 高级
高低 => 高下
高峰 => 岑岭
高高在上 => 居高临下
高古 => 古雅
高贵 => 高尚
高级 => 高等
高峻 => 高大
高慢 => 骄气
高妙 => 高深
高明 => 高超
高朋 => 嘉宾
高人一等 => 头角峥嵘
高尚 => 崇高
高深 => 精深
高声 => 大声
高视阔步 => 气宇轩昂大摇大摆
高视睨步 => 气宇轩昂
高屋建瓴 => 高高在上
高下 => 高低
高兴 => 愉快
高雅 => 文雅
高眼 => 法眼
高招 => 高着儿
高枕而卧 => 无忧无虑
高枕无忧 => 高枕而卧
高着 => 高作
高作 => 高着
膏粱子弟 => 公子哥儿
膏泽 => 恩泽
稿本 => 底稿
告白 => 广告
告别 => 离别
告成 => 乐成
告贷 => 借债
告发 => 密告
告急 => 求助
告假 => 请假
告诫 => 申饬
告竣 => 达成
告老还乡 => 辞职归里
告密 => 告发
告示 => 通告
告诉 => 告知
告知 => 告诉
告终 => 了结
告状 => 起诉
告罪 => 陪罪
戈壁 => 沙漠
割肉医疮 => 望梅止渴
搁笔 => 停笔
搁置 => 弃捐
歌唱 => 歌颂
歌女 => 女乐
歌颂 => 歌唱
阁房 => 内室
阁下 => 旁边
革除 => 铲除
革故鼎新 => 推陈出新
革退 => 斥退
革新 => 改革
革职 => 除名
格斗 => 搏斗
格局 => 格式
格式 => 格局
格外 => 非分特别
格于环境 => 时势所迫
隔岸观火 => 冷眼旁观
隔壁 => 近邻
隔断 => 隔绝
隔阂 => 隔膜
隔绝 => 隔断
隔开 => 离隔
隔邻 => 隔壁
隔膜 => 隔阂
个别 => 个体
个人 => 小我
个人主义 => 本位主义
个体 => 个别
个性难改 => 本性难移
各半 => 参半
各别 => 互异
各不相犯 => 互不侵犯
各不相谋 => 各自为政
各处 => 遍地
各国 => 列国
各尽所能 => 各展其长
各人 => 大家
各式各样 => 林林总总
各抒己见 => 畅所欲言
各位 => 列位
各异 => 各别
各有千秋 => 各有所长
各展其长 => 各尽所能
各执己见 => 互不相让
各执一词 => 各不相谋
各种 => 各类
各自进行 => 各行其是
给予 => 赐与
给与 => 授与
根本 => 基本
根除 => 铲除
根基 => 基础
根据 => 依据
跟班 => 仆从
跟从 => 扈从
跟随 => 追随
亘古未有 => 史无前例
更次 => 更头
更鼓敲尽 => 铜漏滴尽
更换 => 改换
更加 => 加倍
更阑 => 夜阑
更名 => 改名
更头 => 更次
耕具 => 农具
耕耘 => 耕作
耕作 => 垦植
耿介 => 廉洁
工厂 => 工场
工场 => 工厂
工夫 => 功夫
工具 => 对象
工头 => 领班
工致 => 工整
弓鞬 => 弓套
弓手 => 射手
弓套 => 弓鞬
弓足 => 金莲
公布 => 颁布
公差 => 公役
公道 => 公平
公牍 => 公文
公断 => 公评
公告 => 通知布告
公馆 => 第宅
公价 => 官价
公开场合 => 公共场所
公理 => 正义
公民 => 国民
公判 => 公审
公平 => 公正
公评 => 公断
公然 => 果然
公审 => 公判
公事 => 公务
公文 => 公函
公务 => 公事
公役 => 公差
公正 => 公平
公证人 => 评判人
公众 => "大众,"
公子 => 令郎
公子哥儿 => 膏粱子弟
公子王孙 => 纨子弟
功败垂成 => 半途而废
功成身退 => 知难而退
功德 => 好事
功夫 => 工夫
功绩 => 功劳
功劳 => 功绩
功名利禄 => 富贵荣华
功能 => 功效
功效 => 功能
功勋 => 功劳
攻击 => 进击
攻克 => 霸占
攻其不备 => 乘虚而入
攻陷 => 攻下
供不应求 => 求过于供
供词 => 口供
供给 => 供应
供养 => 赡养
供应 => 供给
恭恭敬敬 => 必恭必敬
恭敬 => 恭顺
恭顺 => 恭敬
恭维 => 奉承
共鸣 => 共识
共识 => 共鸣
共同 => 配合
共同努力 => 通力合作
贡献 => 进献
勾搭 => 勾结
勾画 => 勾勒
勾魂摄魄 => 荡气回肠
勾结 => 勾搭
勾栏 => 北里
勾勒 => 勾画
勾通 => 勾结
勾消 => 抹煞
勾引 => 引诱
沟渠 => 水渠
钩心斗角 => 尔虞我诈
狗洞 => 狗窦
狗窦 => 狗洞
狗仗人势 => 驴蒙虎皮
苟且偷安 => 自甘堕落
苟且偷生 => 敷衍塞责
苟求不已 => 诛求无厌
构成 => 组成
构思 => 构想
构想 => 构思
构怨 => 成仇
构造 => 结构
构筑 => 修建
购买 => 购置
购置 => 购买
媾和 => 议和
估计 => 估量
估计打算 => 盘算推算
估量 => 估计
咕咕唧唧 => 喁喁细语
姑息 => 迁就
孤本 => 秘本
孤单 => 孤独
孤独 => 孤单
孤芳自赏 => 自命不凡
孤拐脸 => 孤拐面
孤拐面 => 孤拐脸
孤家寡人 => 孤苦伶仃
孤介 => 孤僻
孤苦 => 伶丁
孤苦伶仃 => 离群索居
孤陋寡闻 => 目光如豆
孤僻 => 孤介
孤注一掷 => 背注一掷
毂下 => 都门
鹘程万里 => 长风万里
古板 => 呆板
古道 => 旧道
古道热肠 => 古貌古心
古董 => 骨董
古怪 => 怪僻
古迹 => 事迹
古井不波 => 老僧入定
古貌古心 => 古道热肠
古人 => 前人
古刹 => 庙宇
古往今来 => 从古到今
古雅 => 高古
谷旦 => 吉日
骨董 => 古董
骨干 => 主干
骨气 => 节气
骨肉 => 骨血
骨血 => 骨肉
蛊惑 => 勾引
鼓吹 => 宣传
鼓动 => 煽动
鼓动感动 => 激昂
鼓励 => 勉励
鼓起 => 兴起
鼓掌 => 拍手
瞽者 => 盲人
固步自封 => 抱残守缺
固结 => 凝结
固然 => 虽然
固若金汤 => 稳如泰山
固执 => 执拗
故步自封 => 停滞不前
故国 => 祖国
故交 => 故友
故旧 => 素交
故居 => 旧居
故里 => 桑梓
故乡 => 家乡
故意 => 有意
故友 => 故交
故宅 => 故园
顾忌 => 忌惮
顾虑 => 挂念
顾盼 => 睥睨
顾问 => 参谋
雇用 => 招聘
瓜代 => 交替
瓜熟蒂落 => 顺理成章
刮风 => 起风
刮目相看 => 另眼相看
寡妇 => 孀妇
寡居 => 孀居
挂彩 => 负伤
挂花 => 负伤
挂记 => 挂心
挂念 => 牵挂
挂心 => 挂记
乖谬 => 谬妄
拐弯抹角 => 旁敲侧击
拐杖 => 手杖
怪诞 => 神怪
怪杰 => 奇人
怪僻 => 古怪
怪样子 => 四不像
关隘 => 关口
关闭 => 封闭
关怀 => 关心
关键 => 症结
关口 => 关隘
关连 => 干系
关联 => 联系关系
关门落锁 => 闭门塞窦
关切 => 关心
关心 => 关怀
关照 => 通知
关注 => 存眷
观 => 不雅
观察 => 视察
观点 => 概念
观光 => 旅行
观看 => 旁观
观赏 => 欣赏
观望 => 张望
官场 => 宦海
官价 => 公价
官吏 => 仕宦
官僚 => 权要
官署 => 官厅
官司 => 讼事
官厅 => 官署
官样文章 => 例行公事
管鲍之交 => 陈雷之契
管工 => 督工
管见 => 鄙见
管库 => 司库
管理 => 治理
管束 => 牵制
管帐 => 司帐
管制 => 管束
管中窥豹 => 坐井观天
贯彻始终 => 坚持到底
贯穿 => 贯串
贯串 => 贯穿
贯注 => 灌注
惯例 => 通例
惯用 => 习用
灌溉 => 浇灌
灌输 => 灌注贯注
灌音 => 录音
光彩 => 光荣
光风霁月 => 冰壶秋月
光复 => 收复
光顾 => 惠顾
光怪陆离 => 千奇百怪
光滑 => 滑腻
光滑油滑 => 圆滑
光辉 => 辉煌
光脚 => 赤脚
光亮 => 光明
光临 => 惠临
光溜溜 => 光秃秃
光芒 => 光线
光明 => 光亮
光明磊落 => 正大光明
光明正大 => 名正言顺
光荣 => 光彩
光天化日 => 青天白日
光秃秃 => 光溜溜
光显 => 鲜明
光阴 => 时间
光阴似箭 => 白驹过隙
广博 => 渊博
广大 => 宽大
广泛 => 普遍
广告 => 告白
广阔 => 辽阔
广漠 => 宽敞豁达
归并 => 合并
归程 => 归途
归还 => 清偿
归咎 => 归罪
归来回头 => 返来
归纳综合 => 概括
归去 => 回去
归天 => 物化
归途 => 归程
归隐志士 => 伏枥老骥
归罪 => 归咎
圭表标准 => 圭臬
圭臬标准 => 圭表
龟年 => 鹤寿
龟婆 => 鸨母
规定 => 划定
规复 => 恢复
规划 => 计划
规矩 => 规则
规律 => 纪律
规模 => 范围
规劝 => 劝戒
规行矩步 => 规规矩矩
规则 => 规矩
闺范 => 阃范
轨范 => 法度模范
诡辩 => 狡辩
诡计 => 阴谋
鬼斧神工 => 巧夺天工
鬼怪 => 鬼魅
鬼鬼祟祟 => 偷偷摸摸
鬼火 => 磷火
鬼哭神号 => 天愁地惨
鬼魅 => 鬼怪
鬼迷心窍 => 鬼摸脑壳
鬼摸脑壳 => 鬼迷心窍
鬼域 => 黄泉
鬼域伎俩 => 阴谋诡计
鬼蜮伎俩 => 卑劣手段
贵宾 => 高朋
贵显 => 显要
贵寓 => 府上
贵重 => 珍贵
桂花 => 木樨
滚存 => 结存
滚蛋 => 滚开
滚瓜烂熟 => 倒背如流
滚滚 => 滔滔
滚开 => 滚蛋
滚水 => 沸水
锅炉 => 汽锅
国粹 => 国学
国都 => 都城
国度 => 国家
国蠹 => 民贼
国法 => 公法
国家 => 国度
国家荣誉 => 邦家之光
国交 => 邦交
国困民艰 => 民穷财尽
国脉 => 邦本
国民 => 公民
国事 => 国是
国是 => 国事
国土 => 领土
国学 => 国粹
国祚 => 鼎祚
果断 => 武断
果腹 => 充饥
果然 => 果真
裹足 => 缠足
过程 => 进程
过错 => 错误
过分 => 过火
过河拆桥 => 不知恩义
过后 => 事后
过后行兵 => 坐失良机
过活 => 度日
过火 => 过分
过目不忘 => 过目成诵
过目成诵 => 目即成诵
过期 => 过时
过去 => 曩昔
过人才略 => 盘盘大才
过甚 => 过火
过甚其辞 => 夸大其词
过甚其实 => 名过其实
过剩 => 多余
过堂 => 审问
过头 => 过火
过问 => 干预干与
过细 => 细致
过夜 => 留宿
过犹不及 => 矫枉过正
海阪 => 海隅
海不扬波 => 风平浪静
海潮 => 浪潮
海底捞针 => 江中钓月
海疆 => 海域
海角天涯 => 天涯海角
海军 => 水师
海阔天空 => 放言高论
海浪 => 波浪
海内 => 国内
海誓山盟 => 天长地久
海隅 => 海阪
海员 => 舵手
骇人听闻 => 危言耸听
害怕 => 畏惧
害臊 => 怕羞
憨厚 => 浑厚
憨实 => 憨厚
含垢忍辱 => 忍尤含诟
含糊 => 暧昧
含糊其词 => 模棱两可
含混 => 含糊
含沙射影 => 架词诬控
含笑 => 浅笑
含笑九泉 => 含笑入地
含笑入地 => 含笑九泉
含辛茹苦 => 历尽艰辛
含羞 => 害羞
含血喷人 => 血口喷人
含义 => 寄义
函牍 => 尺素
寒不择衣 => 饥不择食
寒冬 => 穷冬
寒风 => 北风
寒光 => 冷光
寒害 => 冷害
寒家 => 敝宅
寒冷 => 严寒
寒门饮恨 => 牛衣对泣
寒气 => 冷气
寒舍 => 舍下
寒天 => 冷天
寒暄 => 酬酢
寒衣 => 冬衣
寒战 => 寒噤
罕见 => 罕有
罕用 => 少用
汉文 => 华文
扞格难入 => 格格不入
汗出如浆 => 汗流浃背
汗流浃背 => 汗如雨下
汗青 => 历史
汗如雨下 => 汗出如浆
悍然不顾 => 不顾一切
捍卫 => 保卫
颔首 => 点头
颔首应承 => 点头答应
熯 => 烦忙
翰墨 => 笔墨
翰札 => 简牍
航海 => 帆海
航路 => 航线
航线 => 航路
毫不勉强 => 心甘情愿
毫光 => 光芒
豪放 => 豪迈
豪富 => 大富
豪华 => 奢华
豪杰 => 英雄
豪迈 => 豪放
豪门 => 朱门
豪情 => 激情
豪爽 => 豪放
豪饮 => 牛饮
好本领 => 好身手
好比 => 比如
好不容易 => 十分困难
好菜 => 佳肴
好处 => 利益
好多 => 很多多少
好管闲事 => 多事生非
好汉 => 英雄
好坏 => 利害
好久 => 很久
好看 => 悦目
好梦 => 美梦
好人 => 大好人
好人难做 => 善门难开
好身手 => 好本领
好生之德 => 慈悲心肠
好事 => 功德
好似 => 宛如彷佛
好天 => 晴天
好像 => 似乎
好学 => 勤学
好逸恶劳 => 吊儿郎当
好友 => 石友
号角 => 军号
号令 => 号召
号召 => 号令
浩大 => 浩荡
浩荡 => 浩大
浩繁 => 众多
浩浩荡荡 => 声势赫赫
浩劫 => 大难
浩叹 => 长吁
耗费 => 消耗
耗损 => 耗费
皓首苍颜 => 白发苍颜
诃斥 => 斥骂
呵叱 => 呵斥
呵斥 => 呵叱
呵欠 => 欠伸
呵责 => 呼
喝采 => 叫好
喝彩 => 喝采
喝茶 => 品茗
合并 => 归并
合法 => 正当
合格 => 及格
合股 => 合资
合伙 => 合股
合家 => 百口
合力攻敌 => 戮力同心
合浦珠还 => 失而复得
合身 => 称身
合时 => 应时
合适 => 适合
合资 => 合伙
合作无懈 => 紧密合作
何必 => 何须
何等 => 多么
何干 => 何关
何故 => 何以
何关 => 何干
何堪 => 那堪
何况 => 况且
何须 => 何必
何以 => 何故
何在 => 安在
何足道哉 => 不值一提
和蔼 => 和气
和蔼可亲 => 蔼然可亲
和好 => 亲睦
和缓 => 懈弛
和解 => 息争
和睦 => 和气
和盘托出 => 尽情宣露
和气 => 和蔼
和洽 => 和好
和善 => 和气
和尚 => 僧人
和事老 => 鲁仲连
和顺 => 温柔
和谐 => 协调
和颜悦色 => 平易近人
和议 => 订定合同
河边 => 河畔
河滨 => 河干
河伯 => 河神
河道 => 河流
河流 => 河道
河清海晏 => 水静无波
河神 => 河伯
核办 => 查究
核定 => 审定
核对 => 查对
核心 => 焦点
核阅 => 审阅
荷包 => 钱袋
贺年 => 拜年
贺喜 => 道贺
鹤发 => 白发
鹤立鸡群 => 佼佼不群
鹤寿 => 龟年
黑暗 => 阴郁
黑白 => 诟谇
黑白不分 => 善恶不分
黑沉沉 => 黑洞洞
黑洞洞 => 黑沉沉
黑糊糊 => 黑沉沉
黑幕 => 内幕
黑钱 => 陋规
黑市 => 暗盘
黑魆魆 => 黑沉沉
黑压压 => 黑糊糊
黑黝黝 => 黑沉沉
痕迹 => 陈迹
很多 => 许多
很多多少 => 好多
很久 => 良久
狠毒 => 恶毒
狠恶 => 乖戾
恨入骨髓 => 恨之入骨
恨之入骨 => 恨入骨髓
亨衢 => 通衢
亨通 => 利市
恒河沙数 => 数以万计
恒久 => 长期
横暴 => 凶残
横亘 => 绵亘
横竖 => 反正
横死 => 非命
横行霸道 => 作奸犯科
衡量 => 权衡
衡宇 => 房屋
轰动 => 惊动
轰隆 => 霹雳
哄传 => 盛传
哄人 => 骗人
烘托 => 衬托
弘大 => 宏大
红尘 => 尘凡
红军 => 赤军
红利 => 盈余
红颜 => 朱颜
宏大 => 巨大
宏儒硕学 => 博学多才
宏伟 => 雄伟
洪亮 => 响亮
洪流 => 大水
鸿图 => 鸿猷
鸿猷 => 鹏图
鸿运 => 隆运
猴子 => 山公
后代 => 子女
后盾 => 后援
后果 => 效果
后悔 => 懊悔
后记 => 跋文
后进 => 落后
后来居上 => 青出于蓝
后妻 => 继室
后手 => 背工
后退 => 撤退退却
后援 => 后盾
后坐力 => 反冲力
厚待 => 优遇
厚交 => 深交
厚利 => 重利
厚颜无耻 => 恬不知耻
厚遇 => 厚待
呼喊 => 呼叫招呼
呼唤 => 召唤
呼卢喝雉 => 呼么喝六
呼么喝六 => 呼卢喝雉
呼啸 => 咆哮
呼 => 呵责
忽忽不乐 => 闷闷不乐
忽略 => 疏忽
忽然 => 溘然
忽视 => 疏忽
狐假虎威 => 仗势欺人
狐媚 => 媚惑
狐疑 => 怀疑
胡匪 => 马贼
胡混 => 厮混
胡里胡涂 => 浑浑噩噩
胡闹 => 混闹
胡说 => 乱说
胡思乱想 => 妙想天开
胡天胡地 => 放肆荒唐
胡涂一时 => 聪明一世
胡诌 => 扯谈
胡作非为 => 任性妄为
虎豹 => 豺狼
虎将 => 猛将
虎皮 => 皋比
虎头蛇尾 => 有头无尾
虎帐 => 军营
互不侵犯 => 各不相犯
互不相让 => 各执己见
互换 => 交换
互相研究 => 切磋琢磨
互助 => 合作
怙恶不悛 => 恶性难改
怙恃 => 父母
花白 => 斑白
花草 => 花卉
花旦 => 旦角
花费 => 消费
花卉 => 花草
花名 => 诨名
花圃 => 花园
花容月貌 => 闭月羞花
花天酒地 => 酒绿灯红
花纹 => 斑纹
花样 => 名堂
花园 => 花圃
花招 => 把戏
华而不实 => 脆而不坚
华盖云集 => 门庭若市
华丽 => 华美
华美 => 华丽
华文 => 汉文
哗闹 => 嘈吵喧斗
滑冰 => 溜冰
滑稽 => 幽默
滑稽突梯 => 诙谐百出
滑头 => 狡黠
化名 => 假名
化险为夷 => 逢凶化吉
化妆 => 化装
化装 => 化妆
划船 => 荡舟
划定 => 规定
划一 => 整齐
画饼充饥 => 割肉医疮
画虎成犬 => 刻鹄类鹜
画图 => 绘图
话柄 => 口实
话不投机 => 交浅言深
怀愁 => 抱恨
怀念 => 思念
怀胎 => 受孕
怀疑 => 疑惑
欢畅 => 欢乐
欢快 => 欢乐
欢乐 => 欢快
欢腾 => 欢跃
欢天喜地 => 眉飞色舞
欢喜 => 欢乐
欢欣鼓舞 => 兴高采烈
欢迎 => 迎接
欢跃 => 欢腾
还击 => 回击
还是 => 照样
环抱 => 围绕
环堵萧然 => 家贫壁立
环顾 => 环视
环境 => 情况
环球 => 全球
环绕 => 围绕
环视 => 环顾
环游 => 周游
阛阓 => 商场
缓步 => 徐行
缓步徐行 => 安步当车
缓缓 => 徐徐
缓慢 => 迟缓
幻化 => 变幻
幻境 => 幻梦
幻梦 => 幻境
幻灭 => 破灭
幻想 => 理想
宦官 => 太监
宦途 => 仕途
唤醒 => 叫醒
换帖兄弟 => 拜把兄弟
换衣 => 更衣
涣散 => 散漫
患难夫妻 => 同命鸳鸯
焕然一新 => 面目一新
豢养 => 喂养
荒诞 => 荒谬
荒诞不经 => 荒谬绝伦
荒废 => 旷废
荒凉 => 荒漠
荒谬 => 荒诞
荒谬绝伦 => 荒诞不经
荒漠 => 荒野
荒年 => 凶年
荒疏 => 抛荒
荒唐 => 荒谬
荒芜 => 荒凉
荒野 => 荒原
荒淫无耻 => 荒淫无度
荒淫无度 => 荒淫无耻
荒原 => 荒野
慌不择路 => 寒不择衣
慌慌张张 => 快快当当
慌脚鸡 => 毛姜
慌乱 => 忙乱
慌忙 => 急忙
慌张 => 张皇
黄包车 => 人力车
黄灿灿 => 金灿灿
黄昏 => 傍晚
黄口孺子 => 乳臭未干
黄粱一梦 => 南柯一梦
黄泉 => 鬼域
惶惶 => 惶遽
惶遽 => 惶惶
惶恐 => 惊恐
晃动 => 晃悠
晃悠 => 晃荡
谎话 => 假话
谎言 => 假话
灰尘 => 尘土
灰心 => 泄气
灰心丧气 => 心灰意懒
诙谐 => 滑稽
诙谐百出 => 滑稽突梯
挥动 => 挥舞
挥霍 => 浪费
挥金如土 => 挥霍无度
挥泪 => 洒泪
挥洒自如 => 笔底生花
挥舞 => 挥动
辉煌 => 光辉
辉煌光耀 => 绚烂
回避 => 躲避
回答 => 答复
回复 => 答复
回复复兴 => 复原
回覆 => 答复
回顾 => 回想
回击 => 还击
回籍 => 还乡
回绝 => 拒绝
回去 => 归去
回生 => 复生
回声 => 反响
回收 => 收受接管
回手 => 回击
回首 => 回想
回乡 => 回籍
回想 => 回忆
回销 => 返梢
回心转意 => 改变主张
回旋 => 盘旋
回忆 => 回想
回转 => 反转展转
悔过 => 悔悟
悔恨 => 痛恨
悔悟 => 悔过
汇报 => 报告请示
汇合 => 会合
会餐 => 聚餐
会合 => 汇合
会集 => 会合
会计 => 管帐
会见 => 会面
会面 => 会见
会商 => 谈判
会谈 => 谈判
会堂 => 礼堂
会晤 => 见面
会心 => 会意
会意 => 会心
绘声绘色 => 有声有色
绘声绘影 => 历历如绘
绘图 => 画图
贿赂 => 行贿
晦涩 => 艰涩
惠而不费 => 不伤脾胃
惠顾 => 光顾
毁谤 => 诽谤
毁坏 => 损坏
毁灭 => 扑灭
毁伤 => 损伤
昏暗 => 阴暗
昏倒 => 昏迷
昏瞶 => 颟顸
昏黄 => 朦胧
昏迷 => 晕厥
昏迷不醒 => 不省人事
昏天黑地 => 天昏地暗
婚事 => 亲事
浑厚 => 憨厚
浑浑噩噩 => 胡里胡涂
浑金璞玉 => 天真未凿
浑朴 => 浑厚
浑身 => 满身
浑水摸鱼 => 混水摸鱼
浑浊 => 污浊
魂不附体 => 丢魂失魄
魂飞魄散 => 六神无主
魂飞天外 => 魄散九霄
魂魄 => 灵魂
混合 => 混杂
混居 => 杂居
混乱 => 凌乱
混名 => 花名
混淆 => 混杂
混淆黑白 => 混淆视听
混杂 => 混淆
豁达 => 开朗
豁亮 => 明亮
豁略大度 => 宽宏大量
豁免 => 宽免
豁拳 => 猜拳
豁然开朗 => 名顿开
活动 => 运动
活该 => 该死
活结 => 活扣
活扣 => 活结
活力 => 活气
活龙活现 => 活灵活现
活埋 => 生坑
活泼 => 生动
活气 => 活力
活跃 => 活泼
活捉 => 生擒
活着 => 在世
火把 => 火炬
火锅 => 暖锅
火化 => 火葬
火急 => 弁急
火警 => 失火
火炬 => 火把
火伞高张 => 烈日当空
火上加油 => 泼油救火
火上浇油 => 推波助澜
火食 => 人烟
火头 => 庖丁
火线 => 前线
火油 => 煤油
火灾 => 火警
火葬 => 火化
伙计 => 店员
或人 => 某人
或谓 => 或曰
货币 => 泉币
货仓 => 堆栈
货郎鼓 => 拨浪鼓
货品 => 货物
货色 => 货品
货物 => 货色
获利优厚 => 利市三倍
祸从口出 => 祸发齿牙
祸端 => 祸根
祸发齿牙 => 祸从口出
祸根 => 祸胎
祸国殃民 => 病国殃民
祸患 => 祸殃
祸乱滔天 => 沧海横流
祸殃 => 祸患
讥嘲 => 讥诮
讥讽 => 讽刺
讥诮 => 讽刺
讥笑 => 嘲笑
击鼓 => 伐鼓
击节称赏 => 拍案叫绝
击柝 => 打更
饥肠辘辘 => 大肠告小肠
饥荒 => 饥馑
饥馑 => 饥荒
机动 => 灵活
机会 => 机遇
机警 => 机灵
机灵 => 机警
机密 => 秘密
机敏 => 机灵
机谋 => 权略
机器 => 机械
机遇 => 机会
机智 => 机灵
鸡飞狗跳 => 鸡犬不宁
鸡飞狗走 => 鸡飞狗跳
鸡零狗碎 => 琐屑零星
鸡犬不留 => 斩草除根
积储 => 储蓄储存
积存 => 积压
积德 => 积善
积渐 => 浸渐
积聚 => 积累
积累 => 积聚
积年 => 历年
积年累月 => 年深月久
积习难改 => 积重难返
积蓄 => 蓄积
积压 => 积存
积羽沉舟 => 聚蚊成雷
积重难返 => 积习难改
积贮 => 积蓄
基本 => 根本
基层 => 下层
基础 => 基本
缉捕 => 搜捕
缉获 => 缴获
箕踞 => 盘蹲
稽查 => 稽察查察
稽察 => 稽查查察
稽核 => 考核
稽首 => 顿首
激昂 => 激动慷慨
激动 => 冲动
激愤 => 激怒
激励 => 鼓励
激烈 => 剧烈
激流 => 急流
激怒 => 激愤
激情 => 豪情
激情亲切 => 热忱
激战 => 鏖战
羁系 => 监禁
及锋而试 => 捷足先登
及格 => 合格
及笄年华 => 豆蔻年华
及时 => 实时
吉人 => 良士
吉人天相 => 善者神佑
吉日 => 谷旦
吉士 => 吉人
吉祥 => 祥瑞
吉兆 => 喜兆
岌岌可危 => 一发千钧
汲取 => 吸取
汲水 => 打水
即日 => 克日
即是 => 等于
极点 => 顶点
极度 => 极端
极峰 => 山顶颠峰
极尽描摹 => 淋漓尽致
极乐世界 => 神仙世界
极力 => 死力
极少 => 少少
极新 => 崭新
极刑 => 死刑
极重繁重 => 深重
急变 => 遽变
急公好义 => 慷慨仗义
急乎乎 => 急忙忙
急急 => 吃紧
急遽 => 急忙
急流 => 激流
急忙 => 匆忙
急忙忙 => 急乎乎
急迫 => 急切
急起直追 => 奋起直追
急切 => 迫切
急躁 => 浮躁
急中生智 => 情急智生
疾驰 => 奔驰
疾言厉色 => 正言厉色
棘手 => 辣手
集合 => 聚集
集会 => 聚会会议
集团 => 团体
集腋成裘 => 积少成多
辑录 => 编录
籍籍无名 => 没没无闻
几次 => 几回
几多 => 若干好多
己饥己溺 => 爱人如己
计划 => 筹划
计划精巧 => 算无遗策
计谋 => 计策
计算 => 盘算
计无所出 => 小手小脚
记录 => 记载
记取 => 记着
记载 => 记录
记着 => 记住
伎俩 => 手法
纪录 => 记载
纪律 => 规律
纪年 => 编年
妓院 => 倡寮
忌辰 => 忌日
忌惮 => 顾忌
忌讳 => 隐讳
忌日 => 忌辰
技能 => 技巧
技巧 => 技能
技术 => 技巧
技痒 => 摩拳擦掌
技艺 => 身手
季候 => 时令
季节 => 季候
季世 => 末世
济急 => 救急
济困解危 => 雪中送炭
继承 => 继续
继室 => 后妻
继述 => 绍述
继续 => 持续
继续不停 => 络绎不绝
寂静 => 僻静
寂寥 => 寥寂
寂然 => 肃然
寄存 => 存放
寄放 => 存放
寄父 => 干爹
寄居 => 借居
寄人篱下 => 俯仰由人
寄托 => 依靠
寄义 => 含义
祭奠 => 敬拜
祭祀 => 祭奠
加快 => 加速
加强 => 增强
加入 => 参加
加速 => 加快
夹杂 => 搀杂
佳兵不祥 => 兵凶战危
佳构 => 精品
佳话 => 美谈
佳偶 => 良伴
佳偶天成 => 嘉偶天成
佳肴 => 好菜
佳誉 => 美誉
佳兆 => 吉兆
枷锁 => 桎梏
家常便饭 => 屡见不鲜
家道 => 家境
家景 => 家境
家境 => 家道
家眷 => 家属
家贫壁立 => 环堵萧然
家声 => 门风
家世 => 门第
家书 => 家信
家徒壁立 => 四壁萧条
家徒四壁 => 贫无立锥
家乡 => 故乡
家畜 => 六畜
家属 => 家眷
袈裟 => 法衣
嘉会 => 盛会
嘉奖 => 奖励
嘉偶天成 => 佳偶天成
甲板 => 船面
甲鱼 => 团鱼
价格 => 价钱
价钱 => 价格
价值千金 => 无价之宝
驾返瑶池 => 跨鹤西归
驾驭 => 驾御
驾御 => 驾驭
假贷 => 借贷
假公济私 => 营私舞弊
假话 => 谎话
假冒 => 冒充
假名 => 化名
假票 => 伪钞
假仁假义 => 假装好人
假日 => 沐日
假使 => 借使
假想 => 设想
假意周旋 => 虚与委蛇
假造 => 捏造
假装 => 伪装
假装好人 => 假仁假义
嫁祸他人 => 以邻为壑
嫁妆 => 嫁奁
稼穑 => 农事
戋戋 => 区区
奸刁 => 奸狡
奸棍 => 奸徒
奸滑 => 刁猾
奸狡 => 奸猾
奸骗 => 奸淫
奸巧 => 巧诈
奸商 => 市侩
奸徒 => 奸棍
奸笑 => 狞笑
奸淫 => ***
奸诈 => 奸巧
尖兵 => 哨兵
尖利 => 尖锐
尖锐 => 尖利
尖酸刻薄 => 繁言吝啬
坚壁清野 => 焦土政策
坚持 => 保持
坚持不懈 => 锲而不舍
坚辞 => 峻拒
坚定 => 果断
坚固 => 牢固
坚决 => 果断
坚苦卓绝 => 饱经风霜
坚强 => 顽强
坚忍 => 坚贞
坚韧不拔 => 坚持不懈
坚如盘石 => 坚不可摧
坚守 => 苦守
坚毅 => 刚毅
坚毅不拔 => 威武不屈
坚贞 => 坚毅
坚贞不屈 => 傲雪欺霜
间不容发 => 岌岌可危
间隔 => 距离
肩摩踵接 => 前后相接
肩舆 => 轿子
艰巨 => 艰难
艰苦 => 艰难
艰苦朴素 => 勤勤俭俭
艰难 => 艰苦
艰涩 => 晦涩
艰屯之际 => 多事之秋
兼顾 => 统筹
监督 => 监视
监犯 => 犯人
监禁 => 羁系
监视 => 监督
监狱 => 牢狱
缄口 => 闭口
缄口结舌 => 闭口无言
缄默 => 沉默
缄默沉静 => 沉默
拣选 => 挑撰
俭朴 => 简朴
减弱 => 削弱
减少 => 削减
减刑 => 弛刑
剪刀 => 铰剪
检查 => 检讨
检察 => 审查
检点 => 检束
检核检束 => 检点
检举 => 揭发
检讨 => 检查
检验 => 磨练
简便 => 轻便
简单 => 简略
简牍 => 翰札
简洁 => 简练
简练 => 简洁
简略 => 简单
简略节略 => 节减
简朴 => 俭朴
简要 => 扼要
简易 => 简略单纯
简直 => 的确
翦绺 => 扒手
见地 => 看法
见风使舵 => 见机行事
见告 => 告知
见怪 => 见责
见机 => 识趣
见机行事 => 看风使舵
见教 => 赐教
见解 => 看法
见利忘义 => 财迷心窍
见面 => 会晤
见示 => 见教
见微知着 => 尝鼎一脔
见闻习染 => 目染耳濡
见效 => 奏效
见义勇为 => 无所畏惧
见责 => 见怪
建都 => 定都
建功 => 立功
建国 => 开国
建立 => 树立
建设 => 扶植
贱卖 => 平沽
贱躯 => 粗躯
健壮 => 硬朗
渐渐 => 逐渐
践踏 => 蹂躏
践踏糟踏 => 残害
践言 => 履言
践约 => 依约
践祚 => 莅祚
鉴别 => 辨别
鉴定 => 判定
鉴戒 => 警惕
鉴貌辨色 => 察言观色
江干 => 江畔
江河日下 => 一落千丈
江畔 => 江干
江山 => 山河
江心补漏 => 临渴掘井
将近 => 快要
将就 => 迁就
将来 => 未来
将信将疑 => 半信半疑
将遇良才 => 棋逢敌手
疆场 => 沙场
疆域 => 边境
讲错 => 失言
讲和 => 媾和
讲价 => 论价
讲解 => 讲授
讲究 => 讲求
讲课 => 授课
讲明 => 疏解
讲求 => 讲究
讲授 => 讲解
讲堂 => 课堂
讲义 => 课本
奖励 => 嘉奖
匠意于心 => 胸中有数
降低 => 下降
降服 => 克服
降服佩服 => 投降
降落 => 下降
降生 => 出世
交班 => 接班
交错 => 交织
交代 => 交卸
交锋 => 比武
交换 => 交流
交际 => 外交
交煎 => 交迫
交接 => 交代
交界 => 接壤
交流 => 交换
交迫 => 交煎
交浅言深 => 话不投机
交情 => 友谊
交融 => 融合
交谈 => 攀谈
交替 => 瓜代
交头接耳 => 窃窃私语
交往 => 来往
交心 => 谈心
交易 => 生意业务
交谊 => 情谊
交友 => 结交
交运 => 走运
交谪 => 吵骂
交织 => 交错
郊野 => 郊外
姣美 => 姣好
娇媚 => 妩媚
浇薄 => 浇漓
浇愁 => 解愁
浇漓 => 浇薄
骄傲 => 自满
骄兵必败 => 傲卒多降
骄贵 => 骄矜
骄矜 => 骄贵
骄阳 => 烈日
骄易 => 轻慢
骄子 => 宠儿
骄恣 => 骄纵
骄纵 => 骄恣
胶葛 => 轇轕
胶卷 => 菲林
胶漆相投 => 似漆如胶
焦点 => 核心
焦急 => 着急
焦虑 => 焦炙
焦土政策 => 坚壁清野
焦躁 => 烦躁
轇轕 => 纠葛
角楼 => 谯楼
角色 => 脚色
角逐 => 比赛
佼佼不群 => 鹤立鸡群
狡辩 => 诡辩
狡猾 => 狡诈
狡徒 => 滑头
狡黠 => 滑头
狡诈 => 狡猾
矫健 => 壮健
矫揉造作 => 虚张声势
矫饰 => 卖弄
矫枉过正 => 过犹不及
矫正 => 改正
脚本 => 剧本
脚迹 => 脚印行踪
脚钱 => 力钱
脚色 => 角色
脚踏实地 => 踏踏实实
脚印行踪 => 脚迹
铰剪 => 剪刀
铰链 => 搭钮
搅散 => 搞乱
剿除 => 剿灭
剿灭 => 清剿
缴获 => 缉获
叫喊 => 叫嚷
叫花子 => 老花子
叫唤 => 叫嚷
叫嚷 => 叫唤
叫声 => 啼声
叫嚣 => 呐喊
叫醒 => 唤醒
叫子 => 哨子
较量 => 较劲
教导 => 教诲
教诲 => 教导
教练 => 锻练
教授 => 传授
教唆 => 唆使
教学 => 教授教养
教养 => 教化
教育 => 教导
阶层 => 阶级
阶级 => 阶层
接班 => 交班
接班人 => 接棒人
接办 => 接手
接棒人 => 接班人
接待 => 招待
接二连三 => 连续不断
接管 => 接收
接贵攀高 => 攀龙附凤
接济 => 救济
接纳 => 回收
接洽 => 联系
接壤 => 交界
接收 => 吸收
接手 => 接办
接受 => 接收
接应 => 策应
接于眼前 => 近在眉睫
揭穿 => 揭露
揭疮疤 => 揭隐私
揭发 => 揭露
揭露 => 揭穿
揭幕 => 开幕
揭破 => 揭露
揭隐私 => 揭疮疤
街市商人 => 市井
街头 => 陌头
孑立 => 孤单
节俭 => 节省
节减 => 节略
节流 => 撙节
节女 => 烈女
节拍 => 节奏
节气 => 骨气
节省 => 节俭
节外生枝 => 多此一举
节余 => 结余
节约 => 勤俭
节制 => 控制
节奏 => 节拍
劫夺 => 侵掠
劫夺一空 => 满目荒凉
劫后余生 => 大难不死
劫掠 => 抢掠
劫难 => 灾难
劫数 => 劫运
劫运 => 劫数
杰出 => 出色
杰作 => 佳构
诘问 => 诘责
诘责 => 质问
洁白 => 雪白
洁净 => 干净
结案 => 了案
结草衔环 => 感恩图报
结存 => 滚存
结构 => 构造
结果 => 成果
结合 => 联合
结婚 => 娶亲
结交 => 交友
结局 => 终局
结实 => 壮实
结束 => 停止
结业 => 毕业
结余 => 节余
结怨 => 树敌
捷报 => 喜报
捷足先登 => 疾足先得
截然不同 => 判然不同
竭泽而渔 => 杀鸡取卵
解愁 => 浇愁
解当铺 => 典押铺
解甲归田 => 退役还乡
解聘 => 解职
解剖 => 剖解
解散 => 闭幕
解释 => 说明
解说 => 讲解
解脱 => 摆脱
解围 => 得救
解职 => 解聘
介怀 => 介意
介意 => 介怀
戒备 => 防备
戒勉 => 饬厉
界说 => 定义
界线 => 界限
界限 => 界线
借贷 => 假贷
借单 => 借字
借道 => 借路
借据 => 欠据
借口 => 托言
借款 => 乞贷
借路 => 借道
借势 => 借重
借条 => 借单
借重 => 借势
借主 => 债主
藉槁 => 藉卉
藉卉 => 藉槁
今后 => 往后
今年 => 本年
今生 => 此生
今世 => 当代
今是昨非 => 今非昔比
金灿灿 => 黄灿灿
金风抽丰 => 秋风
金科玉律 => 清规戒律
金口木舌 => 暮鼓晨钟
金兰交 => 莫逆交
金莲 => 弓足
金瓯无缺 => 一统天下
金钱万能 => 钱可通神
金饰 => 细软
金吾不禁 => 城开不夜
金衣玉食 => 鲜衣美食
金玉满堂 => 富可敌国
矜恤 => 悯恤
襟怀 => 肚量
紧急 => 紧迫
紧密 => 慎密
紧密合作 => 合作无懈
紧迫 => 紧急
紧缩 => 压缩
紧要关头 => 生死关头
紧张 => 重要
谨慎 => 谨严
谨小慎微 => 兢兢业业
谨严 => 谨慎
锦衣玉食 => 金衣玉食
尽力 => 努力
尽情 => 纵情
尽情宣露 => 和盘托出
尽善尽美 => 精美绝伦
尽头 => 止境
尽心尽力 => 不遗余力
劲敌 => 强敌
劲头 => 干劲
近况 => 现状
近来 => 最近
近在眉睫 => 接于眼前
进步 => 提高
进场 => 出场
进程 => 过程
进犯 => 抨击打击
进贡 => 纳贡
进取 => 朝上进步
进退两难 => 进退失据
进退失据 => 跋前疐后
进退维谷 => 势成骑虎
进献 => 供献
晋升 => 提升
浸渐 => 积渐
缙绅 => 绅耆
禁绝 => 不准
禁止 => 制止
京彩 => 皮蛋
泾渭不分 => 牝牡骊黄
经国济民 => 匡时济世
经过 => 经由
经籍 => 经书
经纪 => 掮客
经理 => 司理
经历 => 阅历
经书 => 经籍
经心 => 全心
荆天棘地 => 满地荆棘
惊诧 => 惊愕
惊动 => 轰动
惊愕 => 惊诧
惊弓之鸟 => 伤弓之鸟
惊骇 => 惊恐
惊慌 => 惊惶
惊惶 => 惊慌
惊惶失措 => 猝不及防
惊悸 => 惊慌
惊恐 => 惊骇
惊奇 => 惊异
惊叹 => 赞叹
惊讶 => 惊奇
惊疑 => 惊奇
惊异 => 惊奇
旌旗 => 旗子
兢兢业业 => 谨小慎微
精彩 => 出色
精粹 => 精炼
精干 => 精悍
精悍 => 精干
精华 => 精髓
精力 => 精神
精炼 => 精华精辟
精良 => 优良
精美 => 精巧
精美绝伦 => 尽善尽美
精密 => 周详
精巧 => 精致
精确 => 准确
精深 => 精湛
精神 => 精力
精神病 => 神经病
精神抖擞 => 精力充沛
精髓 => 精华
精通 => 精晓
精细 => 精致
精益求精 => 千锤百炼
精湛 => 精深
精致 => 精细
井井有条 => 有条不紊
井然有序 => 井井有条
井蛙语海 => 妄自尊大
景况 => 情状
景色 => 风景
景象 => 气象
景仰 => 钦慕
景致 => 风景
憬悟 => 省悟
警备 => 戒备
警策 => 警励
警察 => 警员
警戒 => 警惕
警句 => 警语
警觉 => 警醒
警励 => 警策
警惕 => 小心
警卫 => 保镳
警语 => 警句
警员 => 警察
净水 => 清水
竞渡 => 赛舟
竞赛 => 比赛
竞走 => 赛跑
竟日 => 镇日
敬拜 => 膜拜
敬服 => 尊崇
敬慕 => 仰慕
敬佩 => 敬仰
敬慎 => 恪慎
敬仰 => 敬佩
敬重 => 敬佩
境地 => 地步
境况 => 景况
境遇 => 际遇
静坐 => 默坐
窘境 => 逆境
窘迫 => 拮据
纠缠不清 => 扳缠不清
纠纷 => 胶葛
纠率 => 鸠率
纠正 => 改正
究竟 => 毕竟
鸠率 => 纠率
鸠形鹄面 => 形容枯槁
鸠拙 => 笨拙
九牛一毫 => 牛之一毛
九牛一毛 => 沧海一粟
久长 => 长久
久旱 => 亢旱
久有存心 => 费尽心机
久远 => 长远
酒菜 => 酒席
酒坊 => 酒肆
酒绿灯红 => 穷奢极欲
酒肆 => 酒坊
酒涡 => 梨涡
酒席 => 酒菜
旧道 => 古道
旧调重弹 => 老生常谈
旧恨 => 宿怨
旧交 => 旧友
旧居 => 故居
旧友 => 故人故交
旧债 => 宿债
旧帐 => 宿帐
咎由自取 => 罪有应得
救急 => 济急
救济 => 救援
救生衣 => 浮水衣
救援 => 救济
就逮 => 落网
就地 => 当场
就寝 => 睡眠
就绪 => 停当
就义 => 捐躯
舅家 => 外氏
居安思危 => 安不忘危
居心 => 用心
居心不良 => 居心叵测
居住 => 栖身
拘捕 => 逮捕
拘谨 => 拘束
拘束 => 拘谨
鞫讯 => 过堂
局促 => 窄小
局促一隅 => 僻处一方
局面 => 局势
局内人 => 个中人
局势 => 局面
咀嚼 => 品味
举案齐眉 => 相敬如宾
举办 => 举行
举杯 => 碰杯
举措 => 举动
举动 => 举措
举动当作 => 算做
举高 => 抬高
举棋不定 => 当机不断
举世 => 环球
举世无匹 => 旷代一人
举事 => 发难
举行 => 举办
举一反三 => 触类旁通
举止高雅 => 落落大方
句斟字嚼 => 咬文嚼字
巨擘 => 巨头
巨大 => 伟大
巨猾 => 大奸
巨贾 => 富商
巨匠 => 大师
巨人 => 伟人
巨头 => 巨子
巨细 => 大小
巨子 => 巨擘
拒捕 => 抗捕
拒绝 => 谢绝
具名 => 签字
剧本 => 脚本
剧盗 => 大贼
剧烈 => 激烈
惧怕 => 害怕
聚餐 => 会餐
聚会 => 聚首
聚会会议 => 集会
聚集 => 集合
聚精会神 => 心神专注
聚敛 => 剥削
聚拢 => 集合
聚散 => 离合
聚沙成塔 => 集腋成裘
聚首 => 聚会
聚蚊成雷 => 积羽沉舟
遽变 => 急变
捐款 => 捐钱
捐钱 => 捐款
捐躯 => 就义
捐献 => 募捐
镌刻 => 雕刻
镌汰 => 淘汰
镌谕 => 恳
卷铺盖 => 炒鱿鱼
狷介 => 清高
隽拔 => 俊拔
隽誉 => 美名
眷属 => 家属
眷注 => 关怀
孓然一身 => 形影相吊
决策 => 决议计划
决定 => 决议
决斗 => 决战
决断 => 定夺
决裂 => 破裂
决死 => 殊死
决议 => 决定
决议计划 => 决策
决战苦战 => 死战
诀别 => 死别
抉择 => 决定
绝壁 => 峭壁
绝不 => 毫不
绝代 => 旷世
绝技 => 特技
绝路末路 => 死路
绝望 => 失望
觉察 => 发觉
觉得 => 认为
觉返迷津 => 迷途知反
觉悟 => 觉醒
觉醒 => 觉悟
倔强 => 顽强
崛起 => 突起
掘客 => 发掘
厥后 => 其后
攫取 => 牟取
军队 => 部队
军多将广 => 兵多将广
军号 => 号角
军火 => 军械
军力 => 兵力
军器 => 军火
军人 => 武士
军事机密 => 戎机
军械 => 军器
军营 => 虎帐
军种 => 兵种
军装 => 戎衣
君子 => 正人
均衡 => 平衡
均派 => 均摊
均摊 => 均派
均匀 => 平均
俊俏 => 姣美
俊秀 => 英俊
俊逸 => 飘逸
峻拒 => 坚辞
峻峭 => 陡峭
馂余 => 冷炙
竣工 => 完工
竣事 => 结束
开拔 => 开赴
开办 => 创办
开辟 => 开拓
开除 => 解雇
开创 => 首创
开导 => 劝导
开端 => 开始
开发 => 开辟
开国 => 建国
开怀 => 舒怀
开火 => 开仗
开禁 => 弛禁
开口 => 启齿
开阔 => 坦荡
开朗 => 爽朗
开麦拉 => 摄影机
开门见山 => 直言不讳
开幕 => 揭幕
开始 => 开端
开释 => 释放
开头 => 开首
开脱 => 摆脱
开拓 => 开辟
开玩笑 => 开顽笑
开顽笑 => 开玩笑
开心 => 高兴
开罪 => 获罪
凯旅 => 班师
楷模 => 榜样
刊出 => 注销
刊登 => 登载
刊定 => 改定
刊误表 => 勘误表
刊行 => 发行
勘察 => 勘探
勘探 => 勘察
勘误表 => 刊误表
堪舆术 => 青鸟术
坎阱 => 罗网
看成 => 算作
看待 => 对待
看法 => 意见
看风使舵 => 量体裁衣
看管 => 把守
看护 => 关照
看破 => 识破
看守 => 看管
看透 => 看破
看望 => 探望
看重 => 重视
康健 => 健康
康庄大道 => 平坦大路
慷慨 => 大方
慷慨解囊 => 仗义疏财
慷慨仗义 => 急公好义
伉俪 => 夫妻
抗捕 => 拒捕
抗衡 => 对抗
抗命 => 逆命
考查 => 考核
考察 => 考核
考场 => 科场
考成 => 考绩
考订 => 订正
考核 => 考察
考绩 => 考成
考究 => 讲究
考据 => 考证
考虑 => 斟酌
考试 => 测验
考语 => 评语
考证 => 考据
犒军 => 劳军
靠岸 => 泊岸
靠近 => 接近
靠拢 => 挨近
苛捐杂税 => 横征暴敛
苛刻 => 刻薄
苛吏 => 酷吏
科场 => 考场
瞌睡 => 打盹儿
可儿 => 可人
可否 => 能否
可贵 => 宝贵
可骇 => 可怕
可靠 => 靠得住
可怕 => 恐怖
可佩 => 可钦
可巧 => 碰巧
可钦 => 可佩
可人 => 可儿
可惜 => 惋惜
可笑 => 好笑
可信 => 可托
可以或许 => 能够
可有可无 => 无关紧要
渴慕 => 渴仰
渴念 => 孺慕
渴望 => 盼望
渴仰 => 渴慕
克服 => 战胜
克复 => 收复
克己 => 低廉甜头
克日 => 刻期
克绍箕裘 => 继志述事
克制 => 抑制
刻薄 => 苛刻
刻骨铭心 => 铭肌镂骨
刻鹄类鹜 => 画虎成犬
刻画 => 描绘
刻苦 => 耐劳
刻意 => 锐意
刻舟求剑 => 缘木求鱼
客长 => 客官
客官 => 客长
客居 => 旅居
客气 => 虚心
客岁 => 去年
客堂 => 客厅
客厅 => 客堂
恪慎 => 敬慎
恪守 => 固守
课本 => 教材
课堂 => 教室
溘然长逝 => 撒手尘寰
肯定 => 确定
恳切 => 诚恳
恳求 => 请求
恳 => 镌谕
空地 => 旷地
空洞 => 空泛
空乏 => 空匮
空泛 => 空洞
空房 => 空屋
空费 => 白费
空腹 => 空肚
空话 => 空论
空空如也 => 一无所有
空匮 => 空乏
空门 => 佛门
空前未有 => 亘古未有
空缺 => 空白
空手 => 白手
空谈 => 空口说
空屋 => 空房
空隙 => 闲暇
空闲 => 余暇
空想 => 幻想
空中阁楼 => 梦幻泡影
空中楼阁 => 蜃楼海市
孔方兄 => 阿堵物
孔教 => 儒教
孔武有力 => 力大无穷
恐怖 => 恐惧
恐慌 => 惊恐
恐惊 => 恐惧
恐惧 => 恐怖
恐惧不安 => 栗栗不安
恐怕 => 生怕
恐吓 => 威吓
控告 => 控诉
控诉 => 控告
控制 => 掌握
口岸 => 港口
口碑载道 => 有口皆碑
口不择言 => 轻诺寡言
口才 => 谈锋
口传 => 口授
口儿 => 口子
口供 => 供词
口号 => 标语
口角 => 吵嘴
口蜜腹剑 => 笑里藏刀
口气 => 口吻
口若悬河 => 滔滔不绝
口实 => 话柄
口试 => 面试
口是心非 => 言行相诡
口授 => 口传
口味 => 口胃
口胃 => 口味
口吻 => 口气
口语 => 白话
口子 => 口儿
叩首 => 叩头
叩头 => 叩首
叩谢 => 伸谢
扣留 => 截留
扣头 => 折扣
扣问 => 询问
扣押 => 拘留收禁
枯寂 => 寂聊
枯荣 => 隆替
枯燥 => 死板
枯燥乏味 => 索然无味
哭泣 => 呜咽
哭笑不得 => 啼笑皆非
窟窿 => 洞穴
苦楚 => 痛楚
苦口婆心 => 语重心长
苦命 => 薄命
苦难 => 魔难
苦恼 => 忧?
苦守 => 死守
苦心焦虑 => 困心衡虑
苦衷 => 苦处
酷爱 => 热爱
酷寒 => 冰冷
酷吏 => 苛吏
酷热 => 炎热
酷暑 => 炎夏
夸大 => 夸张
夸大其词 => 过甚其辞
夸诞 => 浮夸
夸奖 => 称赞
夸耀 => 炫耀
夸张 => 夸大
垮台 => 塌台
跨鹤西归 => 驾返瑶池
快活 => 快乐
快快当当 => 急急忙忙
快乐 => 快活
快马加鞭 => 马不停蹄
快人快事 => 干脆爽快
快要 => 将近
快意 => 如意
脍炙人口 => 到处颂扬
宽敞 => 宽阔
宽大 => 广大
宽宏大量 => 豁略大度
宽解 => 宽心
宽阔 => 宽敞
宽猛相济 => 德威并用
宽免 => 宽贷豁免
宽恕 => 饶恕
宽慰 => 快慰
宽心 => 宽解
宽裕 => 裕如
款待 => 招待
款式 => 格式
款项 => 款子
款子 => 款项
匡时济世 => 经国济民
诓骗 => 敲诈
狂暴 => 狞恶
狂奔 => 疾走
狂潮 => 怒潮
狂风 => 暴风
狂妄 => 傲慢
狂言 => 大言
狂药 => 杜康
诳骗 => 欺诳
况且 => 何况
旷达 => 奔放
旷代一人 => 举世无匹
旷废 => 荒废
旷古 => 太古
旷课 => 缺课
旷日持久 => 空费时日
旷世 => 绝代
旷世一人 => 斗南一人
旷野 => 田野
亏本 => 赔本
亏损 => 吃亏
亏心 => 负心
窥测 => 窥伺
窥伺 => 窥测
窥探 => 窥测
葵扇 => 蒲扇
魁首 => 翘楚
魁伟 => 魁梧
魁梧 => 魁伟
跬步不离 => 如影随形
馈赠 => 奉送
昆虫 => 虫豸
昆季 => 伯仲
捆绑 => 绑缚
阃范 => 闺范
困顿 => 困窘
困乏 => 困倦
困惑 => 迷惑
困窘 => 困顿
困倦 => 困乏
困难 => 艰苦
困绕 => 包围
困心衡虑 => 苦心焦虑
困阻 => 蹇滞
扩大 => 扩展
扩展 => 扩大
扩张 => 扩大
阔别 => 远离
阔绰 => 阔气
阔气 => 阔绰
拉拢 => 收买
邋遢 => 肮脏
腊鼓频催 => 年近岁终
腊尽冬残 => 年近岁迫
辣手 => 棘手
来宾 => 宾客
来回 => 往返
来临 => 光降
来龙去脉 => 前因后果
来路货 => 舶来品
来去 => 往来来往
来日 => 明天将来
来日诰日 => 明天
来世 => 下世
来岁 => 明年
来往 => 交往
来由 => 情由
来源 => 起源
来源根基 => 本原
兰艾俱焚 => 兰艾同烬
兰交 => 至好
兰梦 => 梦熊
拦截 => 拦阻
拦阻 => 拦截
栏杆 => 雕栏
阑珊 => 衰退
蓝本 => 底本
谰言 => 滥调
褴褛 => 破烂
懒惰 => 懒散
懒散 => 懒惰
烂帐 => 漂帐
烂醉陶醉 => 大醉
滥杀无辜 => 视如草芥
滥觞 => 起源
狼狈不堪 => 狼狈万状
狼狈而逃 => 抱头鼠窜
狼狈万状 => 狼狈不堪
狼籍 => 缭乱
狼吞虎咽 => 风卷残云
狼心狗肺 => 恶毒心肠
狼烟 => 烽火
浪潮 => 海潮
浪费 => 糟蹋
浪迹江湖 => 到处为家
浪子 => 荡子
劳而无功 => 吃力不讨好
劳绩 => 收获
劳驾 => 驾临
劳军 => 犒军
劳苦功高 => 丰功伟绩
劳累 => 劳顿
劳碌 => 忙碌
劳神 => 费心
牢固 => 稳固
牢记 => 切记
牢靠 => 坚固
牢牢 => 紧紧
牢笼 => 樊笼
牢骚 => 怨言
牢狱 => 缧绁
唠叨 => 絮聒
老蚌生珠 => 老年得子
老大 => 老迈
老夫 => 老汉
老妇人 => 老太婆
老规矩 => 老例子
老汉 => 老夫
老虎 => 山君
老将 => 宿将
老例 => 通例
老例子 => 老规矩
老练 => 干练
老马识途 => 谙熟门路
老迈 => 垂老
老衲 => 老僧
老年得子 => 老蚌生珠
老年末年 => 暮年
老婆 => 妻子
老起面皮 => 老着脸子
老千 => 翻戏
老人 => 白叟
老僧 => 老衲
老僧入定 => 古井不波
老少 => 老小
老师 => 先生
老实 => 诚实
老手 => 熟手在行
老树枯柴 => 人老珠黄
老太婆 => 老妇人
老态龙钟 => 齿豁头童
老小 => 老少
老朽 => 老拙
老朽无能 => 尸居余气
老着脸子 => 老起面皮
潦倒穷困 => 穷困潦倒
乐不思蜀 => 流连忘返
乐成 => 告成
乐道安贫 => 伏枥守株
乐工 => 乐师
乐谱 => 曲谱
乐师 => 乐工
乐陶陶 => 喜洋洋
乐土 => 乐园
乐意 => 愿意
乐园 => 乐土
乐滋滋 => 乐陶陶
勒令 => 迫令
雷同 => 相同
缧绁 => 监牢
羸弱 => 孱弱
泪流满面 => 泣如雨下
泪如泉涌 => 两眼汪汪
类似 => 相似
累赘 => 包袱
冷淡 => 冷漠
冷风 => 凉风
冷光 => 寒光
冷害 => 寒害
冷汗 => 盗汗
冷箭 => 暗箭
冷静 => 沉着
冷酷 => 冷淡
冷落 => 萧条
冷面 => 冰脸
冷漠 => 冷淡
冷僻 => 生僻
冷气 => 凉气
冷清 => 冷僻
冷天 => 寒天
冷眼旁观 => 坐观成败
冷战 => 暗斗
冷炙 => 馂余
愣住 => 停住
厘革 => 变革
梨涡 => 酒涡
离别 => 拜别
离隔 => 隔开
离合 => 聚散
离合悲欢 => 悲欢离合
离开 => 分开
离奇 => 瑰异
离席 => 退席
离异 => 仳离
离职 => 去职
黎民 => 百姓
罹难 => 遇难
礼法 => 礼制
礼服 => 制服
礼节 => 礼仪
礼帽 => 弁冕
礼品 => 礼物
礼尚往来 => 投桃报李
礼堂 => 会堂
礼物 => 礼品
礼仪 => 礼节
礼制 => 礼法
里手 => 内行
理当 => 应当
理发 => 剃头
理解 => 懂得
理屈词穷 => 目瞪口呆
理想 => 幻想
理由 => 来由
理直气壮 => 义正辞严
力把 => 利巴
力不从心 => 力有未逮
力不胜任 => 力难胜任
力量 => 力气
力难胜任 => 力不胜任
力气 => 力量
力钱 => 脚钱
力求 => 力图
力求进步 => 力图上进
力求上进 => 力争上流
力弱 => 力衰
力衰 => 力弱
力图 => 力争
力图上进 => 力争上游
力有未逮 => 力不从心
力争上游 => 力求进步
历程 => 过程
历尽艰辛 => 千辛万苦
历久 => 耐久
历历如绘 => 绘影绘声
历年 => 积年
历史 => 汗青
立德 => 树德
立地 => 登时
立地书橱 => 两脚书橱
立定脚跟 => 取得根据
立杆见影 => 吹糠见米
立功 => 建功
立即 => 立刻
立刻 => 连忙
立品 => 立身
立身 => 立品
立室 => 受室
立誓 => 发誓
立足 => 容身
利巴 => 力把
利害 => 短长
利剑 => 白
利钱 => 利息
利刃 => 芒刃
利市 => 就手
利市三倍 => 获利优厚
利息 => 利钱
利益 => 好处
利益均沾 => 独享权益
利用 => 应用
利诱 => 迷惑
利欲熏心 => 自私自利
沥血以誓 => 歃血为盟
例外 => 破例
例行公事 => 官样文章
隶属 => 附属
栗栗不安 => 恐惧不安
栗六庸才 => 庸庸碌碌
莅祚 => 践祚
笠帽 => 斗笠
笠衫 => 汗衫
詈骂 => 唾骂
连合 => 团结
连接 => 衔接
连结 => 贯穿连接
连累 => 牵连
连忙 => 急速
连绵 => 绵延
连年 => 比年
连任 => 蝉联
连系 => 连络
连续 => 持续
连续不断 => 接二连三
连珠箭 => 连珠炮
连珠炮 => 连珠箭
怜爱 => 垂怜
怜悯 => 恻隐
怜惜 => 珍视
联合 => 结合
联婚 => 缔姻
联结 => 联络
联系 => 接洽
联系关系 => 关联
联姻 => 攀亲
廉价 => 便宜
廉洁 => 廉明
廉明 => 廉洁
廉正 => 廉洁
脸颊 => 面颊
脸色 => 神色
练习 => 演习
恋爱 => 爱情
恋慕 => 爱慕
恋人 => 情人
良伴 => 良俦
良好 => 优越
良庖 => 名厨
良朋 => 益友
良人 => 夫君
良图 => 美计
良宵 => 良夜
良夜 => 良宵
良友 => 良朋
凉风 => 冷风
凉快 => 凉爽
凉帽 => 草帽
凉爽 => 凉快
粮食 => 食粮
两边 => 双方
两端 => 两头
两极 => 南北极
两面三刀 => 阳奉阴违
两全 => 分身
两头 => 两端
两小无猜 => 青梅竹马
两姓之欢 => 秦晋之好
亮相 => 表态
谅解 => 原谅
量体裁衣 => 相机行事
辽阔 => 广阔
寥寂 => 寂寞
寥寥无几 => 寥若晨星
寥落 => 零落
寥若晨星 => 寥寥无几
嘹亮 => 响亮
撩蜂拨刺 => 撩蜂剔蝎
撩蜂剔蝎 => 撩蜂拨刺
缭乱 => 纷乱
缭绕 => 围绕
镣铐 => 枷锁
了案 => 结案
了不得 => 了不起
了不起 => 了不得
了结 => 了却
了解 => 懂得
了局 => 下场
了如指掌 => 管窥蠡测
料理 => 摒挡
料想 => 猜想
料中 => 估中
列传 => 传记
列队 => 排队
列国 => 各国
列位 => 各位
列阵 => 排阵
劣等 => 下等
劣货 => 次货
劣行 => 败行
烈火 => 猛火
烈女 => 节女
烈日 => 骄阳
烈日当空 => 火伞高张
裂缝 => 裂痕
裂痕 => 裂缝
邻近 => 临近
邻居 => 邻人
邻人 => 邻居
林林总总 => 各种各样
临机处置 => 临机应变
临机应变 => 临机处置
临近 => 邻近
临渴掘井 => 临阵磨枪
临摹 => 摹仿
临盆 => 分娩
临时 => 暂时
淋漓尽致 => 极尽描摹
磷火 => 鬼火
鳞爪 => 琐闻
凛冽 => 凛凛
凛凛 => 凛冽
吝啬 => 小气
吝啬鬼 => 守财奴
伶仃 => 孤立
伶俐 => 聪颖
灵便 => 灵活
灵榇 => 灵柩
灵魂 => 魂魄
灵活 => 灵巧
灵柩 => 灵榇
灵敏 => 敏锐
灵巧 => 灵活
灵药 => 妙药
凌晨 => 清晨
凌驾 => 赶过
凌乱 => 纷乱
凌辱 => 侮辱
陵暴 => 欺侮
陵犯 => 侵占
陵虐 => 陵暴
陵寝 => 陵园
陵夷 => 衰微
陵园 => 陵寝
聆听 => 凝听
零落 => 寥落
零散 => 零碎
零碎 => 零星
零星 => 零碎
领班 => 工头
领导 => 引导
领会 => 体会
领情 => 承情
领土 => 国土
领悟 => 融会
领袖 => 首脑
领域 => 范畴
令出必行 => 驷不及舌
令弟 => 介弟
令阃 => 令正
令郎 => 公子
令坦 => 令婿
令婿 => 令坦
令媛 => 千金
令正 => 令阃
另日 => 他日
另外 => 别的
另眼相看 => 刮目相看
另有 => 尚有
溜冰 => 滑冰
溜达 => 散步
浏览 => 阅读
流畅 => 流利
流传 => 传播
流芳百世 => 千载扬名
流浪 => 流落
流离 => 流浪
流利 => 流畅
流露 => 吐露
流落 => 流浪
流氓 => 地痞
流派 => 派别
流通 => 流畅
流亡 => 亡命
流行 => 风行
流行症 => 传染病
流言 => 谣言
留步 => 停步
留恋 => 迷恋
留神 => 留心
留宿 => 住宿
留心 => 留意
留意 => 留心
六神无主 => 丧魂失魄
六畜 => 家畜
龙凤之姿 => 龙章凤姿
龙马精神 => 生气勃勃
龙脑 => 冰片
龙蛇混杂 => 良莠淆杂
龙腾虎跃 => 龙马精神
龙章凤姿 => 龙凤之姿
笼络 => 拉拢
笼罩 => 覆盖
隆冬 => 严冬
隆然 => 砰然
隆替 => 盛衰
隆运 => 鸿运
隆重 => 盛大
衖堂 => 弄堂
喽啰 => 草头神
陋规 => 黑钱
陋儒 => 俗儒
陋屋 => 蓬门
漏洞 => 破绽
漏网之鱼 => 丧家之犬
露马脚 => 出漏洞
露水 => 露珠
露台 => 天台
露珠 => 露水
噜苏 => 琐碎
卤莽 => 鲁莽
掳掠 => 抢劫
鲁莽 => 莽撞
鲁仲连 => 和事老
录取 => 登科
录音 => 灌音
鹿车共挽 => 夫唱妇随
碌碌无为 => 无所作为
路程 => 旅程
路子 => 门路
戮力同心 => 同仇敌忾
驴唇不对马嘴 => 牛头不对马嘴
驴蒙虎皮 => 狗仗人势
闾里 => 闾阎
闾阎 => 闾里
旅程 => 路程
旅店 => 旅社
旅费 => 盘费盘川
旅馆 => 旅店
旅居 => 客居
旅客 => 搭客
旅舍 => 客店
旅行 => 观光
屡见不鲜 => 习以为常
履历 => 经验
履行 => 实行
履言 => 践言
率尔操觚 => 轻率下笔
率领 => 带领
率土归心 => 天下归心
率土同庆 => 普天同庆
鸾翔凤翥 => 龙飞凤舞
卵白 => 蛋白
乱闯 => 乱撞
乱花 => 乱用
乱来 => 糊弄
乱七八糟 => 杂乱无章
乱说 => 胡说
乱用 => 乱花
乱撞 => 乱闯
掠夺 => 抢夺
掠过 => 擦过
掠面 => 拂面
掠取 => 掠夺
沦落 => 沉溺堕落
沦陷 => 失守
轮船 => 汽船
轮番 => 轮替
轮替 => 轮番
论价 => 讲价
论理学 => 名学
论述 => 阐述
捋臂张拳 => 擦掌磨拳
罗掘俱穷 => 吃尽当光
罗列 => 枚举
罗网 => 坎阱
罗致 => 汲取
啰唆 => 噜苏
啰嗦 => 烦琐
裸露 => 袒露
裸体 => 赤身
络绎不绝 => 接踵而来
落草为寇 => 上山作贼
落第 => 落选
落发 => 削发
落后 => 落伍
落井下石 => 雪上加霜
落空 => 失
落落大方 => 举止高雅
落魄 => 崎岖潦倒
落日 => 夕照
落网 => 就逮
落伍 => 落后
落选 => 落第
麻痹 => 麻木
麻木 => 麻痹
马齿徒增 => 时光虚掷
马到成功 => 旗开马到
马队 => 骑兵
马革裹尸 => 捐躯疆场
马虎 => 纰漏
马脚 => 破绽
马马虎虎 => 因陋就简
马上 => 立时
马首是瞻 => 亦步亦趋
马贼 => 胡匪
码头 => 船埠
埋伏 => 潜伏
埋没 => 湮没
埋头 => 专一
埋怨 => 抱怨
埋葬 => 安葬
买办 => 大班
买卖 => 生意
买通 => 打通
卖力 => 负责
卖弄 => 虚伪
卖文为活 => 笔耕墨耘
颟顸 => 昏瞶
蛮横 => 野蛮
蛮横无理 => 强词夺理
蛮话 => 刁话
蛮人 => 生番
蛮夷 => 戎狄
满地荆棘 => 荆天棘地
满腹忧愁 => 愁肠百结
满坑满谷 => 恒河沙数
满目荒凉 => 十室九空
满身 => 全身
满是 => 全是
满堂 => 举座
满意 => 满足
满盈 => 充塞
满足 => 知足
谩骂 => 咒骂
漫笔 => 随笔
漫不经心 => 心不在焉
漫步 => 散步
漫空 => 长空
漫骂 => 谩骂
漫谈 => 座谈
漫衍 => 分布
蔓延 => 舒展
忙碌 => 劳碌
忙乱 => 慌乱
芒刃 => 利刃
芒鞋 => 草鞋
盲人 => 瞽者
茫无头绪 => 不得要领
莽撞 => 鲁莽
毛病 => 缺点
毛姜 => 慌脚鸡
矛盾 => 抵触
茅厕 => 厕所
茅舍 => 茅屋
茅屋 => 茅舍
茂盛 => 旺盛
冒充 => 假装
冒犯 => 搪突
冒昧 => 唐突
冒失 => 莽撞
冒失鬼 => 失魂鱼
冒死 => 拼命
贸易 => 商业
貌寝 => 寝陋
貌同实异 => 似是而非
没顶 => 溺毙
没关系 => 没紧要
没精打彩 => 愁眉苦脸
没没无闻 => 籍籍无名
没趣 => 败兴
没收 => 充公
没头没脑 => 劈头盖脸
枚举 => 列举
眉飞色舞 => 笑逐颜开
眉开眼笑 => 笑容可掬
眉目 => 端倪
眉目传情 => 目挑心招
眉月 => 初月
梅香 => 婢女
媒介 => 序言
媒人 => 媒妁
媒妁 => 媒人
煤汽灯 => 汽油灯
煤油 => 石油
每况愈下 => 日就衰败
每每 => 往往
每时每刻 => 时时刻刻
每天 => 天天
美观 => 雅观
美好 => 美妙
美计 => 良图
美酒 => 琼浆
美丽 => 俏丽
美满 => 圆满
美满收场 => 曲终奏雅
美梦 => 好梦
美妙 => 美好
美女 => 美男
美人 => 丽人
美人命薄 => 命薄如花
美术大师 => 丹青妙手
美谈 => 嘉话
美味 => 厚味
美意 => 好意
美誉 => 佳誉
媚谄 => 取悦
媚惑 => 狐媚
门第 => 家世
门风 => 家声
门高莫对 => 齐大非偶
门客 => 食客
门路 => 途径
门生 => 学生
门庭若市 => 熙熙攘攘
门外汉 => 外行人
扪心 => 抚心
扪心自问 => 抚躬自问
闷闷不乐 => 怏怏不乐
盟国 => 友邦
盟主 => 牛耳
朦胧 => 昏黄
艨艟 => 兵舰
猛火 => 烈火
猛将 => 虎将
猛进 => 大进
猛烈 => 激烈
猛然 => 蓦地
蒙受 => 遭遇
梦话 => 梦呓
梦幻泡影 => 空中阁楼
梦境 => 梦乡
梦寐以求 => 求之不得
梦乡 => 梦境
梦想 => 妄想
梦熊 => 弄璋
梦呓 => 梦话
弥补 => 填补
弥留 => 垂死
弥漫 => 漫溢
迷糊 => 含混
迷惑 => 困惑
迷恋 => 留恋
迷茫 => 渺茫
迷迷糊糊 => 模模糊糊
迷途 => 失路
糜费 => 糜掷
糜烂 => 腐烂
糜掷 => 糜费
麋集 => 辘集
靡靡之音 => 濮上之音
蘼芜路断 => 秋扇见捐
米饭钱 => 生活费
米已成炊 => 木已成舟
米珠薪贵 => 食玉炊桂
宓羲 => 庖羲
秘本 => 孤本
秘而不泄 => 秘而不宣
秘而不宣 => 秘而不泄
秘笈 => 秘籍
秘籍 => 秘笈
秘诀 => 窍门
秘密 => 机密
秘密交易 => 私相授受
秘密警察 => 盖世太保
秘闻 => 底蕴
秘戏图 => 春宫
密查 => 刺探
密告 => 告密
密码 => 暗码
密密层层 => 密密丛丛
密密丛丛 => 密密层层
密谋 => 谋害
密切 => 亲密
密切追随 => 马首是瞻
密室 => 密屋
密斯 => 女士
密屋 => 密室
蜜意 => 深情
蜜语 => 甜言
绵亘 => 横亘
绵力 => 绵力薄材
绵延 => 连绵
免除 => 免去
免得 => 省得
免去 => 免除
免却 => 省却
免职 => 撤职
免罪 => 赦罪
勉力 => 戮力
勉励 => 鼓励
缅怀 => 怀念
腼腆 => 忸怩
面对 => 面临
面颊 => 脸颊
面孔 => 面貌
面临 => 面对
面貌 => 面孔
面目 => 面貌
面目面貌 => 面容
面目全非 => 涣然一新
面目一新 => 气象一新
面庞 => 脸庞
面前目今 => 眼前
面容 => 面庞
面如死灰 => 面如土色
面色苍白 => 面无人色
面无人色 => 面色苍白
面子 => 体面
苗条 => 修长
描画 => 刻画
描绘 => 描写
描述 => 描写
描写 => 描述
瞄准 => 对准
眇小 => 渺小
渺不可测 => 深奥无极
渺茫 => 迷茫
渺视 => 傲睨
渺小 => 微小
藐视 => 鄙弃
妙策 => 巧计
妙计 => 奇策
妙技 => 技术手段
妙简 => 妙选
妙龄少女 => 二八佳人
妙手 => 好手
妙手回春 => 药到回春
妙算 => 神算
妙闻 => 趣闻
妙想天开 => 胡思乱想
妙选 => 妙简
妙语 => 趣话
妙语横生 => 谈笑风生
妙语连珠 => 妙语如珠
妙语如珠 => 妙语连珠
庙门 => 山门
庙宇 => 寺院
灭顶 => 溺死
灭尽 => 灭绝
灭绝 => 灭尽
灭亡 => 消亡
蔑视 => 鄙弃
篾片 => 傍友
民 => 平易近
民风 => 民俗
民间文学 => 通俗文学
民气 => 人心
民穷财尽 => 国困民艰
民生凋敝 => 百孔千疮
民俗 => 民风
民心 => 民气
民怨沸腾 => 大快人心
民贼 => 国贼
民众 => 大众
泯没 => 湮灭
泯灭 => 耗费
悯恻 => 哀怜
悯恤 => 怜恤
敏捷 => 迅速
敏锐 => 灵敏
名不副实 => 有名无实
名厨 => 良庖
名存实亡 => 名不副实
名顿开 => 豁然开朗
名高引谤 => 树大招风
名贵 => 宝贵
名过其实 => 过甚其实
名流 => 绅士
名片 => 咭片
名胜 => 胜景
名士 => 名流
名堂 => 花样
名学 => 逻辑学
名誉 => 声誉
名震一时 => 声誉鹊起
明白 => 明确
明火执仗 => 明目张胆
明见万里 => 明鉴万里
明鉴万里 => 明见万里
明净 => 清白
明镜高悬 => 秦镜高悬
明朗 => 晴明
明亮 => 通亮
明了 => 清楚明了
明目张胆 => 堂堂皇皇
明年 => 来岁
明器 => 冥器
明枪暗箭 => 明争暗斗
明确 => 明白
明日黄花 => 时过境迁
明晰 => 了了
明显 => 显著
明哲保身 => 一尘不染
明争暗斗 => 明枪暗箭
鸣金收兵 => 偃旗息鼓
冥具 => 明器
铭肌镂骨 => 刻骨铭心
铭记 => 铭刻
铭刻 => 铭记
铭心镂骨 => 耿耿于怀
命薄如花 => 美人命薄
命根子 => 命脉
命令 => 敕令
命脉 => 命根子
命名 => 定名
命途多舛 => 生不逢辰
命途坎坷 => 偃蹇困穷
命运坎坷 => 穷途潦倒
命中 => 射中
谬爱 => 错爱
谬妄 => 荒谬
摸索 => 探索
摹仿 => 临摹
模范 => 榜样
模仿 => 模拟
模糊 => 隐约
模棱两可 => 含糊其词
模拟 => 模仿
模型 => 模子
模样形状 => 式样
模子 => 模型
膜拜 => 跪拜
摩拳擦掌 => 捋臂将拳
磨砺以须 => 抖擞精神
磨练 => 考验
磨炼 => 锤炼
磨难 => 灾祸
磨铁成针 => 水滴石穿
抹杀 => 扼杀
抹煞 => 勾消
末端 => 末尾
末节 => 小节
末了 => 最后
末路 => 恼
末世 => 季世
陌生 => 生疏
陌头 => 街头
莫逆交 => 金兰交
漠不关心 => 缩手旁观
漠视 => 疏忽
蓦地 => 骤然
墨客 => 诗人
墨绿 => 茶青
默不作声 => 张口结舌
默默无言 => 默不作声
默然 => 沉默
默算 => 心算
默坐 => 静坐
牟利 => 取利
牟取 => 攫取
谋害 => 密谋
谋划 => 策划
谋利 => 投机
谋略 => 盘算
谋面 => 碰面
谋生 => 营生
谋事在人 => 成事在人
某人 => 或人
母财 => 母钱
母大虫 => 母老虎
母范 => 母仪
母舅 => 娘舅
母老虎 => 母大虫
母钱 => 母财
母仪 => 母范
木柴 => 木料
木筏 => 木排
木工 => 木匠
木匠 => 木工
木料 => 木柴
木排 => 木筏
木人石心 => 铁石心肠
木炭 => 柴炭
木屋 => 板屋
木樨 => 桂花
木已成舟 => 米已成炊
目标 => 目的
目不识丁 => 胸无点墨
目不邪视 => 目无流视
目不斜视 => 目不转睛
目次 => 目录
目的 => 目标
目瞪口呆 => 木鸡之呆
目光 => 眼光
目光如电 => 目光如炬
目光如豆 => 目光短浅
目光如炬 => 目光如电
目空一切 => 自高自大
目力 => 视力
目录 => 目次
目前 => 今朝
目染耳濡 => 目擩耳染
目若朗星 => 目若悬珠
目若悬珠 => 目若朗星
目使颐令 => 目指气使
目送手挥 => 手挥目送
目无法纪 => 目无王法
目无流视 => 目不邪视
目无王法 => 目无法纪
目下 => 面前目今
目眩魂摇 => 目眩心花
目眩神迷 => 目眩魂摇
目指气使 => 目使颐令
目中无人 => 目空一切
沐日 => 假日
沐浴 => 洗澡
牧歌 => 农歌
募捐 => 捐献
墓地 => 坟场
墓木已拱 => 尸骨早寒
墓穴 => 泉台
暮鼓晨钟 => 金口木舌
暮年 => 晚年
暮气 => 死气
暮气沉沉 => 灰心丧气
拿定主意 => 打定主意
内涵 => 内在
内耗 => 内讧
内讧 => 内耗
内疚 => 忸怩
内里 => 内中
内乱 => 内争
内幕 => 内情
内情 => 内幕
内人 => 内子
内室 => 闺阁
内外 => 表里
内心 => 心坎
内行 => 行家
内在 => 内涵
内争 => 内
内中 => 内里
内助 => 浑家
内子 => 内人
内 => 内乱
那边 => 那里
那处 => 那里那边
那个 => 谁人
那堪 => 何堪
那里 => 那边
纳宠 => 娶妾
纳福 => 享福
纳贡 => 进贡
纳凉 => 乘凉
乃至 => 甚至
奶名 => 小名
奈何 => 若何怎样
耐烦 => 耐心
耐久 => 经久
耐心 => 耐烦
男儿膝下有黄金 => 男子汉大丈夫
男人 => 汉子
男子 => 须眉
男子汉大丈夫 => 男儿膝下有黄金
南北极 => 两极
南边 => 南方
南方 => 南边
南柯一梦 => 黄粱一梦
南辕北辙 => 背道而驰
难熬难过 => 难受
难道 => 岂非
难得 => 可贵
难懂 => 难明
难分轩轾 => 不分高下
难过 => 惆怅
难堪 => 为难
难免 => 不免
难民营 => 收容所
难明 => 难解
难舍难分 => 藕断丝连
难受 => 难熬痛苦
难听逆耳 => 刺耳
难以想象 => 不可思议
囊空如洗 => 阮囊羞涩
曩昔 => 以前
恼 => 末路
恼恨 => 愤恨
恼怒 => 愤怒
脑袋 => 脑壳
脑筋 => 头脑
脑壳 => 脑袋
脑子 => 头脑
闹饥荒 => 打饥荒
闹热热烈繁华 => 喧闹
呐呐 => 期艾
能否 => 可否
能够 => 可以或许
能力 => 才能
能人 => 强人
能手 => 妙手
能言善辩 => 舌粲莲花
泥坑 => 泥淖
泥淖 => 泥塘
泥沙俱下 => 牛骥同皂
泥土 => 土壤
你死我活 => 不共戴天
拟订 => 订定
逆境 => 困境
匿伏 => 埋伏
溺爱 => 宠爱
溺死 => 灭顶
腻烦 => 厌烦
腻滑 => 平滑
拈花惹草 => 弄柳拈花
年初 => 岁首年月
年代 => 年月
年底 => 岁尾
年华 => 韶华
年纪 => 年事
年近岁终 => 腊尽冬残
年景 => 年成
年老 => 年迈
年龄 => 年纪
年末 => 岁终
年青 => 年轻
年轻 => 年青
年轻力壮 => 手轻脚健
年轻貌美 => 绮年玉貌
年深日久 => 年湮代远
年深月久 => 积年累月
年事 => 年纪
年岁 => 年事
年头 => 岁首
年湮代远 => 年深日久
年夜 => 大年夜
年月 => 年代
年终 => 年关
念佛 => 念经
念经 => 念佛
念念不忘 => 时刻不忘
念书 => 读书
念兹在兹 => 念念不忘
娘舅 => 母舅
酿成 => 变成
鸟语花香 => 桃红柳绿
捏词 => 设辞
捏造 => 假造
啮臂之交 => 死生之契
摰友 => 好友
蹑手蹑脚 => 轻手轻脚
宁当玉碎 => 宁死不屈
宁静 => 安静
宁肯 => 宁可
宁死不屈 => 宁当玉碎
宁愿 => 情愿
狞恶 => 狂暴
狞笑 => 奸笑
凝集 => 凝聚
凝结 => 凝聚
凝聚 => 凝集
凝神 => 凝思
凝视 => 注视
凝思 => 凝神
凝听 => 聆听
凝望 => 凝睇
凝滞 => 呆滞
牛耳 => 盟主
牛骥同皂 => 泥沙俱下
牛山濯濯 => 草木不生
牛头不对马嘴 => 驴唇不对马嘴
牛衣对泣 => 寒门饮恨
牛饮 => 豪饮
忸怩 => 腼腆
农夫 => 农民
农歌 => 牧歌
农具 => 耕具
农历 => 阴历
农民 => 农人
农人 => 农民
农事 => 稼穑
浓厚 => 浓重
浓密 => 稠密
浓郁 => 浓烈
浓云 => 彤云
浓重 => 浓厚
浓妆艳抹 => 浓装艳裹
浓装艳裹 => 浓妆艳抹
脓包 => 饭桶
弄狗相咬 => 挑拨是非
弄堂 => 衖堂
弄月 => 赏月
奴婢 => 奴仆
奴仆 => 仆众
奴视 => 卑视
奴颜媚骨 => 卑躬屈膝
努力 => 尽力
怒不可遏 => 拊膺切齿
怒潮 => 狂潮
怒冲冲 => 气汹汹
怒发冲冠 => 发上指冠
怒吼 => 咆哮
怒目 => 横目
怒气 => 肝火
怒气冲冲 => 怒气冲发
怒气冲发 => 怒气冲冲
怒视 => 瞪眼
女婢 => 女侍
女乐 => 歌女
女伶 => 女优
女士 => 密斯
女侍 => 女婢
女优 => 女伶
女中豪杰 => 女中丈夫
女中丈夫 => 女中豪杰
虐待 => 荼毒
虐政 => 暴政
暖锅 => 火锅
暖和 => 温暖
挪动转移 => 搬动
挪用 => 调用
懦夫 => 怯夫
懦弱 => 脆弱
讴歌 => 赞美
呕吐 => 吐逆
偶尔 => 偶然
偶合 => 巧合
偶然 => 有时
藕断丝连 => 难舍难分
趴下 => 爬下
爬山 => 登山
爬下 => 趴下
爬行动物 => 爬虫类
怕惧 => 惊怕
怕羞 => 含羞
拍案叫绝 => 拍桌惊叹
拍马屁 => 捧臭脚
拍门 => 敲门
拍手 => 鼓掌
拍照 => 摄影
徘徊 => 彷徨
徘徊歧路 => 彷徨歧途
排斥 => 排挤
排除 => 消除
排队 => 列队
排挤 => 排斥
排解 => 排遣
排练 => 排演
排列 => 分列
排山倒海 => 雷霆万钧
排泄 => 渗出
排演 => 排练
排印 => 付梓
排阵 => 列阵
牌坊 => 牌楼
牌号 => 商标
牌楼 => 牌坊
牌照 => 派司
派别 => 流派
派遣 => 吩咐消磨
派司 => 牌照
派头 => 气派
攀登 => 攀缘
攀附 => 攀援
攀龙附凤 => 攀高结贵
攀龙趋凤 => 攀龙附凤趋炎附势
攀亲 => 联姻
攀谈 => 交谈
攀援 => 攀附
攀缘 => 攀登
盘缠 => 盘费
盘点 => 清点
盘蹲 => 箕踞
盘费 => 盘川
盘根错节 => 千头万绪
盘货 => 盘点
盘据 => 割据
盘踞 => 占据
盘弄 => 拨弄
盘盘大才 => 过人才略
盘算 => 计算
盘算推算 => 估计打算
盘问 => 盘考
盘旋 => 回旋
盘游 => 般游
判词 => 判语
判定 => 剖断
判断 => 断定
判然不同 => 迥然不同
判语 => 判词
叛变 => 变节
叛乱 => 兵变
叛逆 => 起义
叛逃 => 潜逃
盼望 => 希望
滂湃 => 滂沱
滂沱 => 滂湃
滂沱大雨 => 倾盆大雨
庞大 => 宏大
庞大无比 => 硕大无朋
庞眉皓发 => 白发银须
庞杂 => 复杂
旁观 => 观察迟疑
旁征博引 => 引经据典
旁证 => 干证
抛摆 => 抛撇
抛荒 => 疏弃
抛撇 => 抛摆
抛弃 => 摈弃
抛清 => 撇清
咆哮 => 呼啸
庖丁 => 伙头
袍笏登场 => 粉墨登场
跑江湖 => 跑码头
跑马 => 赛马
跑码头 => 跑江湖
跑堂 => 侍者
泡茶 => 沏茶
陪伴 => 陪同
陪衬 => 衬托
陪侍 => 随侍
陪同 => 陪伴
陪罪 => 告罪
培养 => 造就
培育 => 培养
培植 => 培养
赔本 => 亏本
赔偿 => 补偿
赔罪 => 赔礼
佩带 => 佩戴
佩戴 => 佩带
佩服 => 信服
配房 => 厢房
配合 => 合营
配角 => 副角
配景 => 背景
配偶 => 配头
配头 => 妃耦
配置 => 设置装备摆设
喷鼻 => 喷鼻香
喷鼻香 => 喷香
歕饭 => 喷饭
抨击 => 鞭挞
砰然 => 隆然
烹调 => 烹饪
烹饪 => 烹调
朋比为奸 => 狼狈为奸
朋侪 => 友人
朋分 => 瓜分
朋友 => 同伙
蓬葆 => 蓬头
蓬菖人 => 蓬户士
蓬发 => 蓬葆
蓬莱仙境 => 蓬瀛仙境
蓬门 => 蓬荜
蓬首垢面 => 披头散发
蓬头历齿 => 头童齿豁
蓬瀛仙境 => 蓬莱仙境
鹏程万里 => 前途似锦
澎湃 => 彭湃
捧臭脚 => 拍马屁
捧头 => 抱头
捧住 => 端住
碰杯 => 举杯
碰鼻 => 碰钉子
碰壁 => 碰鼻
碰到 => 碰着
碰钉子 => 碰壁
碰面 => 谋面
碰巧 => 恰巧
碰运气 => 试试看
批驳 => 批评
批红判白 => 偷天换日
批判 => 批评
批评 => 批驳
批准 => 同意
纰漏 => 忽略
披垂 => 披散
披肝沥胆 => 推诚相见
披荆棘 => 披荆斩棘
披荆斩棘 => 披荆棘
披览 => 披阅
披散 => 披垂
披沙拣金 => 去伪存真
披头散发 => 蓬首垢面
披星带月 => 披霜冒露
披星戴月 => 披星带月
披阅 => 披览
劈叉 => 劈腿
劈面 => 迎面
劈头 => 起源
劈头盖脸 => 没头没脑
劈腿 => 劈叉
霹雳 => 轰隆
霹雳战 => 闪电战
皮蛋 => 京彩
皮郛 => 皮囊
皮娇肉嫩 => 十指尖尖
皮开肉绽 => 鳞伤遍体
皮毛 => 外相
皮囊 => 皮郛
毗连 => 连接
毗邻 => 邻接
疲惫 => 疲乏
疲乏 => 疲惫
疲倦 => 疲惫
疲劳 => 疲惫
疲塌 => 拖拉
蚍蜉撼树 => 不自量力
脾气 => 性格
匹俦 => 佳偶
匹马不还 => 匹马只轮
匹马只轮 => 匹马不还
仳离 => 离异
圮绝 => 屏绝
癖好 => 嗜好
屁滚尿流 => 一蹶不振
睥睨 => 顾盼
僻处一方 => 局促一隅
僻典 => 僻事
僻静 => 寂静
僻事 => 僻典
僻巷 => 穷巷
片段 => 片断
片断 => 片段
片甲不留 => 屁滚尿流
片刻 => 少焉
片面 => 单方面
片面之词 => 片面之言
片面之言 => 片面之词
偏爱 => 偏心
偏差 => 误差
偏激 => 过火
偏见 => 成见
偏僻 => 荒僻罕见
偏向 => 倾向
偏心 => 偏幸
偏幸 => 偏爱
偏言 => 曲说
偏重 => 着重
骈体文 => 四六文
骗局 => 圈套
骗人 => 哄人
剽窃 => 抄袭
漂泊 => 流浪
漂亮 => 英俊
漂帐 => 烂帐
飘泊 => 流散
飘荡 => 飘扬
飘零 => 漂荡
飘扬 => 飘荡
飘逸 => 潇洒
票据 => 单子
慓悍 => 剽悍
撇清 => 抛清
瞥见 => 看见
拼凑 => 拼集
拼集 => 拼凑
贫乏 => 穷困
贫寒 => 清贫
贫贱交 => 布衣交
贫苦 => 穷苦
贫困 => 贫苦
贫民 => 穷人
贫无立锥 => 一贫如洗
频繁 => 频仍
频频 => 一再
频仍 => 频繁
品德 => 品格
品格 => 品德
品格清高 => 仙风道骨
品级 => 等级
品貌 => 丰度
品茗 => 喝茶
品评 => 批评
品味 => 咀嚼
品行 => 操行
品质 => 品德
牝牡 => 雌雄
牝牡骊黄 => 泾渭不分
聘请 => 聘任
聘任 => 聘请
聘用 => 聘请
平安 => 安然
平安无事 => 安然无恙
平常 => 平凡
平旦 => 平明
平淡 => 平庸
平地一声雷 => 石破天惊
平凡 => 平常
平分 => 等分
平分秋色 => 不相上下
平沽 => 贱卖
平和 => 温和
平衡 => 均衡
平滑 => 腻滑
平静 => 镇静
平局 => 平手
平民 => 布衣
平明 => 平旦
平日 => 常日
平生 => 生平
平时 => 日常平凡
平手 => 平局
平素 => 平昔
平坦 => 平展
平稳 => 安稳
平昔 => 平素
平心而谈 => 持平立论
平心静气 => 心平气和
平易近人 => 平易近民
平庸 => 平淡
平展 => 平坦
平正 => 平允
评比 => 评选
评断 => 评议
评话 => 说书
评论辩论 => 谈论
评判人 => 公证人
评判员 => 裁判员
评释 => 表明
评议 => 评断
评语 => 考语
凭单 => 笔据
凭据 => 凭证
凭空捏造 => 闭门造车
屏蔽 => 屏障
屏绝 => 圮绝
屏气凝神 => 收视返听
屏弃 => 摈弃
屏障 => 樊篱
萍泊 => 萍浮
萍浮 => 萍泊
萍水相逢 => 不期而遇
泼妇 => 悍妇
迫不得已 => 必不得已
迫不及待 => 迫在眉睫
迫害 => 危害
迫近 => 逼近
迫良为娼 => 逼良为娼
迫令 => 勒令
迫切 => 急切
破除 => 废除
破费 => 花费
破釜沉舟 => 背城借一
破耗 => 破钞
破坏 => 损坏
破例 => 例外
破裂 => 决裂
破灭 => 幻灭
破碎 => 破裂
破晓 => 凌晨
破绽 => 马脚
魄力 => 气魄
剖白 => 辨白
剖辨 => 别析
剖腹藏珠 => 因噎废食
剖解 => 解剖
剖判 => 剖释
剖析 => 分析
仆从 => 奴隶
仆欧 => 跑堂
仆人 => 家丁
仆役 => 仆人
仆众 => 奴婢
扑面 => 劈面
扑灭 => 息灭
铺保 => 店保
铺排张扬 => 铺张扬厉
铺平 => 摊平
铺张扬厉 => 铺排张扬
匍匐 => 蒲伏
蒲扇 => 葵扇
濮上之音 => 靡靡之音
朴实 => 朴素
朴素 => 朴实
朴直 => 梗直
朴拙 => 真诚
普遍 => 广泛
普度众生 => 普济群生
普渡众生 => 普度众生
普天同庆 => 率土同庆
普通 => 通俗
普通化 => 大众化
七零八落 => 乱七八糟
七上八下 => 忐忑不定
七通八达 => 四通八达
七嘴八舌 => 人多口杂
沏茶 => 泡茶
妻子 => 老婆
凄惨 => 悲凉
凄凉 => 悲凉
凄切 => 悲凉
栖流所 => 难民营
戚属 => 亲串
期艾 => 呐呐
期待 => 等待
期间 => 时代
期限 => 刻日
欺负 => 欺侮
欺凌 => 欺负
欺骗 => 诱骗
欺软怕硬 => 欺善怕恶
欺侮 => 欺负
欺压 => 欺负
欺诈 => 讹诈
漆黑 => 黝黑
蹊径 => 门路
齐备 => 完好
齐大非偶 => 门高莫对
齐全 => 齐备
其后 => 厥后
其时 => 当时
其中 => 个中
奇策 => 妙计
奇怪 => 奇异
奇迹 => 事业
奇丽 => 秀丽
奇妙 => 奥妙
奇人 => 怪杰
奇特 => 独特
奇异 => 奇怪
歧路 => 岔路支路
歧视 => 轻视
歧途 => 邪路
祈祷 => 祷告
崎岖 => 曲折
崎岖潦倒 => 落魄
骑兵 => 马队
骑虎难下 => 进退维谷
棋逢敌手 => 将遇良才
棋战 => 对弈
旗鼓相当 => 旗敌相当
旗号 => 旗帜
旗开马到 => 马到成功
旗手 => 旗头
旗头 => 旗手
旗帜 => 旗号
綦重 => 极重
乞哀告怜 => 摇尾乞怜
乞贷 => 借钱
乞援 => 讨援
企图 => 妄图
岂非 => 难道
岂论 => 不论
启程 => 出发
启齿 => 开口
启迪 => 启发
启发 => 启示
启蒙 => 发蒙
启示 => 启发
杞人忧天 => 庸人自扰
起草 => 草拟
起程 => 出发
起初 => 起先
起飞 => 腾飞
起风 => 刮风
起伏 => 升沉
起火点 => 发火点
起家 => 起身
起落 => 升降
起锚 => 拔锚
起始 => 肇端
起誓 => 发誓
起首 => 首先
起诉 => 告状
起头 => 开端
起因 => 原由
起用 => 升引
起源 => 来源
绮年玉貌 => 年轻貌美
绮绮子弟 => 绮襦纨裤
绮襦纨裤 => 绮绮子弟
气昂昂 => 雄赳赳
气度 => 气宇
气氛 => 氛围
气愤 => 生气
气概 => 气势
气概气派 => 魄力
气鼓鼓 => 气冲冲
气贯长虹 => 气冲牛斗
气候 => 气象
气呼呼 => 气
气绝 => 断气
气力 => 力量
气魄 => 气势
气势 => 气概
气势派头 => 风格
气势汹汹 => 八面威风
气吞山河 => 叱咤风云
气味 => 气息
气息 => 气味
气息奄奄 => 人命危浅
气象 => 气候
气宇 => 气度
气壮山河 => 气吞山河
气 => 气呼呼
弃捐 => 弃置
弃取 => 取舍
弃文就武 => 弃文竞武
汽船 => 轮船
汽锅 => 锅炉
汽油灯 => 煤汽灯
器量 => 度量
器重 => 重视
恰当 => 适当
恰到好处 => 适可而止
恰好 => 正好
恰恰 => 恰好
恰巧 => 刚巧
恰如其分 => 恰到好处
恰似 => 好似
洽商 => 洽谈
洽谈 => 洽商
千般 => 百般
千古流芳 => 流芳百世
千金 => 令媛
千了百当 => 百了千当
千篇一律 => 一模一样
千奇百怪 => 光怪陆离
千算万算，不值天一划 => 人算不如天算
千万 => 万万
千载难逢 => 千载一时
千载一时 => 千载难逢
千真万确 => 确切不移
迁就 => 姑息
迁徙 => 迁移
迁移 => 迁徙
迁移转变 => 转折
牵挂 => 挂念
牵累 => 缠累
牵连 => 连累
牵涉 => 牵扯
谦恭 => 谦和
谦和 => 谦恭
谦让 => 推让
谦善 => 谦虚
谦虚 => 谦逊
谦逊 => 谦虚
签订 => 签署
签署 => 签订
前辈 => 先辈
前车可鉴 => 前车之鉴
前车之鉴 => 前车可鉴
前程 => 前途
前次 => 上次
前锋 => 先锋
前赴后继 => 前仆后继
前后相接 => 肩摩踵接
前呼后拥 => 前呼后应
前进 => 进步
前景 => 远景
前仆后继 => 前赴后继
前去 => 前往
前世 => 宿世
前世怨仇 => 夙世冤家
前思后想 => 忖前思后
前途 => 前程
前途似锦 => 鹏程万里
前往 => 前去
前夕 => 前夜
前线 => 前哨
前言 => 媒介
前夜 => 前夕
前兆 => 预兆
虔诚 => 忠诚
虔敬 => 虔诚
钱币 => 货币
钱财 => 财帛
钱袋 => 荷包
钱可通神 => 金钱万能
钱粮 => 赋税
掮客 => 经纪
潜藏 => 躲藏
潜伏 => 埋伏
潜逃 => 叛逃
黔黎 => 黔首
黔驴技穷 => 黔驴之技
黔驴之技 => 黔驴技穷
黔首 => 黔黎
浅薄 => 浅陋
浅近 => 浅易
浅陋 => 浅薄
浅色 => 淡色
浅显 => 浅易
浅笑 => 含笑
浅易 => 浅近
遣散 => 解散
谴责 => 训斥
缱绻 => 绸缪
欠安 => 不佳
欠好 => 不好
欠亨 => 不通
欠据 => 借据
欠伸 => 呵欠
欠债 => 负债
歉岁 => 荒年
歉仄 => 抱歉
腔调 => 声调
强暴 => 强横
强词夺理 => 蛮横无理
强大 => 壮大
强敌 => 劲敌
强横 => 强暴
强健 => 强壮
强迫 => 强制
强人 => 能人
强盛 => 强大
强制 => 强迫
强壮 => 强健
抢夺 => 掠夺
抢劫 => 掳掠
抢救 => 挽救
抢先 => 争先
悄悄 => 静静
悄然默默 => 静静
敲诈 => 讹诈
敲诈勒索 => 巧取豪夺
敲榨勒索 => 软硬兼取
乔迁之喜 => 出谷迁乔
乔妆 => 改扮
谯楼 => 角楼
巧夺天工 => 鬼斧神工
巧合 => 偶合
巧计 => 妙策
巧妙 => 奇妙
巧取豪夺 => 敲诈勒索
巧舌 => 巧言
巧言 => 巧语
俏丽 => 美丽
翘楚 => 俊彦
切齿腐心 => 深恶痛绝
切齿痛恨 => 痛心疾首
切磋 => 商讨
切磋琢磨 => 互相研究
切断 => 割断
切肤之痛 => 切身痛苦
切合 => 符合
切谏 => 直谏
切口 => 瘦语
切脉 => 把脉
切身 => 亲身
切身痛苦 => 切肤之痛
切题 => 贴题
怯夫 => 懦夫
窃窃私议 => 交头接耳
窃笑 => 暗笑
惬意 => 舒服
亲串 => 戚属
亲密 => 密切
亲昵 => 密切
亲朋 => 亲友
亲切 => 亲热
亲热 => 亲切
亲身 => 亲自
亲事 => 婚事
亲信 => 心腹
亲友 => 亲朋
侵犯 => 侵占
侵害 => 损害
侵陵 => 陵犯
侵略 => 侵犯
侵占 => 侵犯
秦晋之好 => 两姓之欢
勤奋 => 勤恳
勤俭 => 节约
勤恳 => 勤奋
勤劳 => 勤奋
勤勉 => 勤恳
勤勤俭俭 => 艰苦朴素
勤学 => 好学
勤学不辍 => 孜孜不倦
寝陋 => 貌寝
寝食不安 => 食不甘味
寝室 => 卧室
寝衣 => 睡衣
沁人肺腑 => 沁人心脾
沁人心脾 => 沁人肺腑
青出于蓝 => 后来居上
青春 => 芳华
青葱 => 青翠
青翠 => 青葱
青红皁白 => 是非曲直
青梅竹马 => 两小无猜
青鸟使 => 使者
青鸟术 => 堪舆术
青天 => 彼苍
青天白日 => 光天化日
青云之志 => 鸿鹄之志
青云直上 => 平步青云
轻便 => 简便
轻渎 => 亵渎
轻而易举 => 易如反掌
轻浮 => 轻佻
轻忽 => 忽视
轻率 => 草率
轻率下笔 => 率尔操觚
轻慢 => 慢待
轻蔑 => 轻视
轻巧 => 轻盈
轻视 => 歧视
轻佻 => 轻浮
轻微 => 稍微
轻细 => 轻微
轻易 => 随意马虎
轻盈 => 轻巧
倾耳细听 => 洗耳恭听
倾盖论交 => 倾盖之交
倾盖之交 => 倾盖论交
倾家荡产 => 败尽家业
倾慕 => 爱慕
倾盆大雨 => 滂沱大雨
倾诉 => 倾吐
倾吐 => 倾诉
倾向 => 偏向
倾销 => 推销
倾泻 => 倾注
倾心 => 倾慕
倾圯 => 崩裂
倾轧 => 排挤
倾注 => 倾泻
清偿 => 了债
清澈 => 清亮
清晨 => 凌晨
清除 => 消除
清楚 => 清晰
清点 => 盘点
清高 => 高傲
清规戒律 => 金科玉律
清洁 => 干净
清静 => 僻静
清朗 => 明亮清明
清冷 => 清凉
清理 => 清算
清凉 => 清冷
清亮 => 清澈
清贫 => 贫寒
清平世界 => 太平时世
清癯 => 清瘦
清瘦 => 清癯
清爽 => 清新
清算 => 清理
清晰 => 清楚
清闲 => 安闲
清香 => 幽香
清新 => 清爽
清醒 => 苏醒
清秀 => 秀气
清早 => 清晨
情报 => 谍报
情不自禁 => 不由自主
情感 => 情绪
情急智生 => 急中生智
情况 => 情形
情面 => 人情
情人 => 恋人
情势 => 形式
情同骨肉 => 情同手足
情同手足 => 情同骨肉
情形 => 情况
情绪 => 情感
情义 => 情谊
情谊 => 情义
情意 => 情义
情有独锺 => 情之所锺
情愿 => 宁愿
情之所锺 => 情有独锺
晴天 => 好天
擎天一柱 => 砥柱中流
顷刻 => 刹那
请安 => 存问
请假 => 告假
请柬 => 请帖
请教 => 就教
请求 => 要求
请帖 => 请柬
请援 => 讨救
请愿 => 示威
庆贺 => 庆祝
庆幸 => 光荣
庆祝 => 庆贺
罄竹难书 => 擢发难数
穷究 => 深究
穷苦人 => 穷鬼
穷苦相 => 穷相
穷人 => 穷汉
穷山垩水 => 穷乡僻壤
穷途末路 => 断港绝潢
穷乡僻壤 => 穷山恶水
穷巷 => 僻巷
穷源竟委 => 穷源溯流
穷源溯流 => 穷源竟委
琼浆 => 美酒
秋风 => 金风抽丰
秋毫无犯 => 耕市不惊
秋蓬 => 飘蓬
秋日 => 秋天
秋扇见捐 => 蘼芜路断
秋天景色 => 秋景
囚禁 => 软禁
囚首垢面 => 不修边幅
囚徒 => 阶下囚
求过于供 => 供不应求
求和 => 乞降
求名求利 => 名利双收
求乞 => 叫化
求全谴责 => 责难
求饶 => 讨饶
求神拜鬼 => 拜鬼求神
求贤若渴 => 爱才若命
求学 => 肄业
求之不得 => 梦寐以求
求助 => 乞助
泅水 => 拍浮
区别 => 差别
区区 => 戋戋
曲岸 => 曲堤
曲堤 => 曲岸
曲稿 => 唱本
曲解 => 歪曲
曲谱 => 乐谱
曲说 => 偏言
曲折 => 弯曲
曲折小路 => 羊肠小道
曲直 => 是曲
曲终奏雅 => 美满收场
驱策 => 驱使
驱驰 => 奔走
驱赶 => 驱逐
驱使 => 使令
驱逐 => 驱赶
屈从 => 屈服
屈打成招 => 私刑逼供
屈服 => 屈从
屈驾 => 劳驾
屈曲 => 愚昧
屈辱 => 辱没
趋附者众 => 如蚁附膻
趋势 => 趋向
趋向 => 趋势
趋之若鹜 => 趋附者众
取出 => 掏出
取代 => 代替
取得根据 => 立定脚跟
取缔 => 取消
取暖和 => 取暖
取舍 => 弃取
取消 => 撤消
取信 => 守信
娶妻 => 授室
娶妾 => 纳宠
去处 => 行止
去年 => 客岁
去世 => 逝世
去伪存真 => 披沙拣金
去职 => 离职
阒寂无声 => 鸦雀无声
趣话 => 妙语
趣闻 => 妙闻
圈套 => 骗局
圈外人 => 第三者
全部 => 全体
全军 => 三军
全军尽没 => 全军覆没
全靠 => 端赖
全力以赴 => 尽心尽力
全面 => 周全
全能 => 万能
全神贯注 => 聚精会神
全是 => 满是
全体 => 全部
全无分别 => 一丘之貉
全心 => 经心
全心全意 => 专心致志
全愈 => 病愈
权柄 => 权益
权贵 => 显贵
权衡 => 衡量
权力 => 权利
权利 => 权力
权门 => 豪门
权谋 => 机谋
权势 => 势力
权势巨子 => 权威
权术 => 权谋
权威 => 威望
权要 => 官僚
泉源 => 来源
犬牙交错 => 犬牙相制
劝导 => 疏导
劝告 => 奉劝
劝戒 => 规劝
劝善 => 惩恶
劝说 => 劝告
劝慰 => 安慰
缺点 => 缺陷
缺乏 => 缺少
缺课 => 旷课
缺少 => 缺乏
缺陷 => 缺点
却是 => 倒是
雀斑 => 斑点
确当 => 的当
确定 => 肯定
确切 => 确实
确切不移 => 千真万确
确实 => 确切
确凿 => 确实
群策群力 => 集思广益
群丑跳梁 => 群魔乱舞
群魔乱舞 => 群丑跳梁
髯毛 => 胡须
让步 => 妥协
让开 => 闪开
扰乱 => 捣乱
惹恼 => 触怒
热爱 => 酷爱
热潮 => 高潮
热忱 => 热情
热诚 => 真诚
热点 => 热门
热烈 => 热闹
热门 => 热点
热闹 => 热烈
热情 => 热忱
热心 => 热情
人地相宜 => 地利人和
人定胜天 => 谋事在人
人多口杂 => 七嘴八舌
人浮于事 => 僧多粥少
人给家足 => 丰衣足食
人工流产 => 打胎
人间 => 人世
人杰地灵 => 地灵人杰
人口 => 生齿
人老珠黄 => 老树枯柴
人力车 => 黄包车
人民 => 国民
人情 => 情面
人情冷暖 => 世态炎凉
人去楼空 => 室迩人遐
人算不如天算 => 千算万算，不值天一划
人为 => 工资
人心不古 => 世道沦亡
人性 => 人道
人烟 => 火食
人缘 => 分缘
人云亦云 => 吠形吠声
人中表表 => 铁中铮铮
仁慈 => 善良
仁至义尽 => 穷力尽心
忍不住 => 不由得
忍苦 => 吃苦俭朴
忍耐 => 忍受
忍让 => 谦让
忍受 => 忍耐
认敌为友 => 认贼为子
认可 => 承认
认识 => 熟悉
认为 => 以为
认贼为子 => 认敌为友
认真 => 卖力
任命 => 录用
任务 => 义务
任性 => 率性
任意 => 随意率性
妊娠 => 怀胎
仍旧 => 仍然
日积月累 => 穷年累月
日记 => 日志
日就衰败 => 每况愈下
日志 => 日记
日中则昃 => 盛极必衰
戎机 => 军事机密
戎马 => 兵马
戎衣 => 军装
荣幸 => 幸运
荣耀 => 光荣
荣誉 => 声誉
容光焕发 => 精神抖擞
容许 => 允许
容易 => 轻易
容隐 => 包庇
溶化 => 熔解
溶解 => 消融
熔化 => 融化
融合 => 融会
融化 => 熔化
融会 => 融合
冗杂 => 芜杂
柔美 => 优美
柔嫩 => 优柔
柔柔 => 轻柔
柔软 => 柔嫩
柔弱 => 荏弱
柔顺 => 和婉
蹂躏 => 践踏
蹂躏踹踏 => 踩踏辚轹
肉搏 => 搏斗
如出一辙 => 千篇一律
如此 => 如斯
如法泡制 => 照猫画虎
如果 => 假如
如何 => 若何
如何是好 => 如之奈何
如饥似渴 => 迫不及待
如胶似漆 => 水乳交融
如今 => 现在
如日方升 => 蒸蒸日上
如丧考妣 => 如失父母
如失父母 => 如丧考妣
如拾草芥 => 俯拾地芥
如许 => 这样
如有 => 若有
如约 => 履约
如之奈何 => 如何是好
如坐针毡 => 芒刺在背
儒教 => 孔教
孺慕 => 渴念
乳臭未干 => 黄口孺子
入耳 => 中听
入国问俗 => 入境问禁
入境问禁 => 入国问俗
入口 => 进口
入寇 => 犯境
入款 => 进款
入迷 => 出神
入木三分 => 力透纸背
入伍 => 参军
入夜 => 天黑
软禁 => 囚禁
软弱 => 脆弱
软梯 => 绳梯
软硬兼取 => 敲榨勒索
锐利 => 锋利
锐意 => 克意
润色 => 润饰
润饰 => 修饰
润泽 => 滋润
若何怎样 => 奈何
若明若暗 => 雾里看花
若有 => 如有
撒谎 => 说谎
撒酒疯 => 发酒疯
撒泼 => 撒野
撒手 => 放手
撒手尘寰 => 溘然长逝
撒野 => 撒泼
洒泪 => 挥泪
洒脱 => 潇洒
鳃鳃过虑 => 杞天之忧
赛过 => 胜过
赛马 => 跑马
赛跑 => 竞走
赛舟 => 竞渡
三回九曲 => 三回九转
三回九转 => 三回九曲
三军 => 全军
三千珠履 => 宾客盈庭
三五成群 => 成群结队
三言两语 => 一言半语
三足鼎立 => 鼎足之势
散播 => 散布
散布 => 分布
散步 => 漫步
散发 => 披发
散伙 => 分伙
散乱 => 狼藉
散漫 => 涣散
散逸 => 闲逸
丧父 => 失怙
丧家之犬 => 漏网之鱼
丧尽天良 => 丧心病狂
丧母 => 失恃
丧失 => 损失
丧事 => 凶事
丧心病狂 => 丧尽天良
骚动 => 纷扰
骚乱 => 动乱
扫除 => 清除
扫径以待 => 倒履相迎
扫墓 => 省墓
扫尾 => 收尾
扫兴 => 失望
色彩 => 颜色
色泽 => 光彩
森林 => 丛林
僧多粥少 => 人浮于事
僧人 => 和尚
杀害 => 杀戮
杀鸡骇猴 => 杀一儆百
杀鸡取卵 => 竭泽而渔
杀戮 => 屠杀
杀身成仁 => 成仁取义
沙岸 => 沙滩
沙漠 => 戈壁
沙滩 => 沙岸
沙哑 => 嘶哑
刹那 => 霎时
刹时 => 瞬间
傻里傻气 => 笨头笨脑
歃血为盟 => 沥血以誓
煞费苦心 => 费尽心血
霎时 => 刹那
山川 => 山水
山峰 => 山岳
山公 => 猴子
山河 => 江山
山君 => 老虎
山门 => 庙门
山盟海誓 => 金石之盟
山水 => 山川
山寨 => 盗窟
删节 => 删省
煽动 => 鼓动
煽惑 => 煽动
闪电战 => 霹雳战
闪动 => 明灭
闪烁 => 闪耀
闪烁其词 => 深加隐讳
闪耀 => 闪烁
闪灼 => 闪耀
善策 => 良策
善恶不分 => 黑白不分
善良 => 仁慈
善门难开 => 好人难做
善始善终 => 有头有尾
善士 => 慈善家
善于 => 擅长
善者神佑 => 吉人天相
缮写 => 抄写
擅长 => 善于
擅自 => 私自
膳食 => 炊事
赡养 => 养活
赡养费 => 米饭钱
伤风 => 感冒
伤害 => 损害
伤时感事 => 忧国忧民
伤心 => 悲伤
商店 => 市肆
商定 => 约定
商量 => 磋商
商榷 => 商议
商讨 => 商议
商业 => 贸易
商议 => 商讨
赏赐 => 犒赏
赏罚 => 奖惩
赏给 => 赐给
赏光 => 赏脸
赏脸 => 赏光
赏心悦目 => 心旷神怡
赏月 => 弄月
上次 => 前次
上当 => 受骗
上帝 => 天主
上风 => 优势
上彀 => 上网
上将 => 大将
上进 => 长进
上网 => 上彀
上下 => 高低
尚有 => 另有
烧毁 => 销毁
稍纵即逝 => 电光石火
韶光 => 时光
韶华 => 年光光阴
少不更事 => 年幼无知
少见多怪 => 见识浅短
少年老成 => 少年事重
少气无力 => 死气沉沉
少少 => 极少
少用 => 罕用
绍述 => 继述
哨兵 => 尖兵
哨子 => 叫子
奢侈 => 奢靡
奢华 => 豪华
奢靡 => 奢侈
舌敝唇焦 => 费尽唇舌
舌粲莲花 => 能言善辩
舌战 => 激辩
蛇矛 => 长枪
蛇头鼠眼 => 獐头鼠目
舍本逐末 => 本末倒置
舍下 => 寒舍
设备 => 装备
设施 => 举措措施
设席 => 设宴
设想 => 假想
设宴 => 设席
设置装备摆设 => 设备
射手 => 弓手
涉猎 => 浏览
涉水 => 渡水
赦免 => 赦宥
赦宥 => 赦免
赦罪 => 免罪
摄影机 => 开麦拉
申饬 => 告诫
申明 => 声名
申述 => 申说
申说 => 申述
申诉 => 申述
申雪 => 昭雪
伸开 => 张开
伸张 => 蔓延
身不由己 => 情不自禁
身材 => 身体
身段 => 身材
身分 => 成分
身故 => 身死
身后 => 死后
身世 => 出身
身死 => 身故
身体 => 身材
身形 => 体态
绅耆 => 缙绅
深奥 => 深邃
深奥无极 => 渺不可测
深藏若虚 => 守愚藏拙
深沉 => 深邃深挚
深谷 => 幽谷
深厚 => 深挚
深刻 => 深入
深情 => 蜜意
深秋 => 暮秋
深入 => 深刻
深思 => 沉思
深思熟虑 => 深图远虑
深邃 => 深奥
深图远虑 => 深思熟虑
深宵 => 更阑
深湛 => 精深
深重 => 极重繁重
神采 => 神情
神采飞扬 => 神采奕奕
神采奕奕 => 精神奕奕
神出鬼没 => 出没无常
神经病 => 精神病
神情 => 神色
神色 => 神情
神算 => 妙算
神态 => 神志
神往 => 向往
神仙 => 仙人
神仙世界 => 极乐世界
神姿 => 丰采
审察 => 端相
审定 => 核定
审判 => 审讯
审慎 => 谨慎
审视 => 审阅
审问 => 鞠问
审讯 => 审判
审阅 => 核阅
渗入渗出 => 渗透
渗透 => 渗入渗出
慎重 => 郑重
蜃楼海市 => 空中楼阁
升沉 => 起伏
升级 => 进级
升降 => 起落
升平 => 泰平承平
升引 => 起用
生不逢辰 => 命途多舛
生产 => 临盆
生长 => 发展
生齿 => 人口
生存 => 生计
生动 => 活泼
生而知之 => 不学而能
生番 => 蛮人
生活 => 生涯
生机 => 活力
生机勃勃 => 朝气蓬勃
生坑 => 活埋
生理 => 心理
生龙活虎 => 龙精虎猛
生路 => 活门
生命 => 性命
生僻 => 冷僻
生气 => 朝气
生气勃勃 => 生机勃勃
生气希望 => 生机
生擒 => 活捉
生日 => 诞辰
生杀与夺 => 宠辱祸福
生生不已 => 生息不断
生生世世 => 世世代代
生事 => 闹事
生手 => 外行
生疏 => 陌生
生死 => 死活
生死关头 => 紧要关头
生吞活剥 => 不求甚解
生息不断 => 生生不已
生性 => 素性
生涯 => 生活
生养 => 生育
生意业务 => 交易
声调 => 音调
声东击西 => 出奇制胜
声名 => 申明
声名狼藉 => 臭名远扬
声气 => 声息
声色俱厉 => 疾言厉色
声势赫赫 => 浩浩荡荡
声望 => 名誉
声息 => 声气
声誉 => 荣誉
声誉鹊起 => 名震一时
声援 => 支援
牲口 => 牲畜
牲畜 => 畜生
胜负 => 输赢
胜景 => 名胜
胜利 => 成功
胜券在握 => 瓮中捉鳖
笙歌 => 歌乐
绳索 => 绳子
绳梯 => 软梯
绳子 => 绳索
省察 => 省检
省城 => 省垣
省得 => 免得
省掉 => 免却
省检 => 省察
省墓 => 扫墓
省垣 => 省城
盛传 => 哄传
盛大 => 隆重
盛德 => 大德
盛会 => 嘉会
盛极必衰 => 日中则昃
盛气凌人 => 气焰万丈
盛情 => 盛意
盛食厉兵 => 严阵以待
盛饰 => 浓妆
盛行 => 风行
盛意 => 盛情
剩余 => 残剩
尸骨 => 尸骸
尸骨早寒 => 墓木已拱
尸骸 => 尸骨
尸谏 => 死谏
尸解 => 登仙
尸居余气 => 老朽无能
尸体 => 尸首
尸位素餐 => 持禄
失 => 掉
失策 => 失察
失察 => 失算
失常 => 变态
失而复得 => 合浦珠还
失怙 => 丧父
失魂鱼 => 冒失鬼
失礼 => 失仪
失路 => 迷途
失落 => 失踪
失期 => 负约
失窃 => 失贼
失去 => 落空
失色 => 失神
失慎 => 不慎
失时 => 失机
失事 => 出事
失恃 => 丧母
失守 => 沦陷
失望 => 绝望
失笑 => 发笑
失信 => 失约
失言 => 讲错
失业 => 赋闲
失贼 => 失窃
失之交臂 => 当面错过
失职 => 渎职
师出无名 => 兵出无名
施礼 => 见礼
施展 => 发挥
狮子搏兔 => 泰山压卵
湿漉漉 => 湿淋淋
湿润 => 潮湿
十分困难 => 好不容易
十拿九稳 => 万无一失
十全十美 => 浑然一体
十丈软红 => 花花世界
十指尖尖 => 皮娇肉嫩
十足 => 实足
石崇之富 => 邓通之财
石工 => 石匠
石匠 => 石工
石蜡 => 白腊
时不我待 => 时不再来
时不再来 => 时不我待
时代 => 时期
时光 => 时间
时光虚掷 => 马齿徒增
时过境迁 => 明日黄花
时候 => 时刻
时机 => 机会
时价 => 市价
时间 => 时光
时来运转 => 否极泰来
时髦 => 时兴
时期 => 时代
时时 => 不时
时时刻刻 => 每时每刻
时势 => 时事
时兴 => 时髦
时值 => 时价
识别 => 辨认
识趣 => 见机
实话 => 真话
实际 => 现实
实施 => 实行
实时 => 及时
实事求是 => 量力而行
实物 => 什物
实习 => 练习
实行 => 实施
实验 => 试验
实用 => 适用
实在 => 其实
实质 => 本质
拾零 => 鳞爪
拾人牙慧 => 拾人涕唾
蚀本 => 亏本
食不甘味 => 寝食不安
食客 => 门客
食粮 => 粮食
食品 => 食物
食玉炊桂 => 米珠薪贵
食斋 => 吃素
莳植 => 种植
史乘 => 史籍
史书 => 史乘
矢誓 => 矢语发誓
矢无虚发 => 百发百中
矢语发誓 => 矢誓
豕突狼奔 => 东逃西窜
使臣 => 青鸟使
使命 => 任务
使气 => 负气
使用 => 应用
始终如一 => 持之以恒
始祖 => 鼻祖
世伯 => 父执
世故 => 圆滑
世界大同 => 天下一家
世世代代 => 生生世世
世态炎凉 => 人情冷暖
仕宦 => 官吏
仕途 => 宦途
市道市情 => 市面
市集 => 阛阓
市井 => 街市商人
市侩 => 奸商
市面 => 市情
市肆 => 市廛
示威 => 请愿
示知 => 见知
事变 => 事项
事故 => 变乱
事过境迁 => 世易时移
事后 => 过后
事迹 => 业绩
事件 => 事宜
事情 => 工作
侍从 => 随从
侍者 => 酒保
势力 => 权势
势如破竹 => 所向无敌
势如水火 => 积不相容
视察 => 观察
视而不见 => 置若罔闻
视力 => 目力
视如草芥 => 滥杀无辜
视死如归 => 舍身殉难
视为心腹 => 百依百顺
试试 => 尝尝
试试看 => 碰运气
试验 => 实验
饰演 => 扮演
室如悬磬 => 家徒壁立
是非 => 长短
是非分明 => 明辨是非
是非黑白 => 青红皂白
是曲 => 曲直
适才 => 刚才
适当 => 恰当
适得其反 => 拔苗助长
适合 => 合适
适口 => 可口
适时 => 合时
适宜 => 合适
适应 => 顺应
适用 => 实用
舐犊情深 => 老牛舐犊
逝世 => 去世
释教 => 佛教
嗜好 => 癖好
收藏 => 珍藏
收场 => 结束
收复 => 光复
收获 => 收成
收据 => 收条
收留 => 收容
收罗 => 搜聚
收买 => 拉拢
收容 => 收留
收拾 => 整理
收缩 => 压缩
收条 => 收据
收效 => 见效
收支 => 进出
手本 => 抄本
手刺 => 名片
手段 => 手腕
手法 => 手段
手挥目送 => 目送手挥
手简 => 手翰
手脚 => 四肢举动
手忙脚乱 => 惊慌失措
手轻脚健 => 年轻力壮
手腕 => 手段
手无寸铁 => 赤手空拳
手杖 => 拐杖
手足昆季 => 昆仲
手足胼胝 => 手足重茧
手足同心 => 同气连枝
手足无措 => 七手八脚
手足重茧 => 手足胼胝
守兵 => 戍卒
守财奴 => 吝啬鬼
守分 => 守拙
守旧 => 保守
守口如瓶 => 缄舌闭口
守身如玉 => 洁身自爱
守望相助 => 同舟共济
守卫 => 保卫
守正不阿 => 正直无私
守拙 => 守分
首创 => 开创
首次 => 初次
首恶 => 元凶
首领 => 首级
首脑 => 领袖
首先 => 起首
首相 => 辅弼
首要 => 重要
寿辰 => 诞辰
受宠若惊 => 被宠若惊
受饿 => 挨饿
受贿 => 纳贿
受惊 => 吃惊
受苦 => 刻苦
受骗 => 上当
狩猎 => 佃猎
授课 => 讲课
授人以柄 => 倒持泰阿
授室 => 娶妻
瘦弱 => 消瘦
书橱 => 书柜
书柜 => 书橱
书函 => 书札
书籍 => 书本
书柬 => 书函
书箧 => 书箱
书生 => 墨客
书箱 => 书箧
书信 => 手札
书页 => 册页
抒怀 => 抒情
抒难 => 解危
纾难 => 抒难
枢纽关头 => 关节
殊死 => 决死
殊效 => 特效
梳妆 => 打扮
疏导 => 劝导
疏忽 => 忽视
疏弃 => 荒废
疏散 => 分散
疏松 => 松散
疏通 => 疏浚
舒畅 => 舒服
舒服 => 舒畅
舒怀 => 开怀
舒展 => 伸展
输赢 => 胜负
熟练 => 闇练
熟识 => 熟悉
熟悉 => 熟习
熟习 => 熟悉
署理 => 代理
署名 => 签名
署书 => 榜书
术士 => 方士
术数 => 法术
戍卒 => 守兵
束缚 => 约束
束手无策 => 一筹莫展
述说 => 陈述
树大招风 => 名高引谤
树德 => 立德
树范 => 树模
树立 => 建立
树模 => 树范
树怨 => 结怨
庶务 => 碎务
数量 => 数目
数目 => 数量
数奇 => 不偶
衰落 => 式微
衰年 => 颓龄
衰弱 => 虚弱
衰退 => 阑珊
衰微 => 陵夷
双方 => 两边
双宿双飞 => 莲开并蒂
孀居 => 寡居
爽快 => 爽直
爽朗 => 开朗
爽利 => 爽气爽直
爽性 => 干脆
爽直 => 爽快
谁人 => 那个
水滴石穿 => 磨铁成针
水点 => 水滴
水费 => 水脚
水果 => 生果
水患 => 水灾
水火不容 => 方枘圆凿
水火倒悬 => 水深火热
水脚 => 水费
水落石出 => 内情毕露
水平 => 程度
水渠 => 沟渠
水上人家 => 浮家泛宅
水深火热 => 水火倒悬
水师 => 海军
水手 => 海员
水土不服 => 不服水土
水灾 => 水患
睡房 => 寝室
睡衣 => 寝衣
顺便 => 趁便
顺产 => 安产
顺次 => 按序
顺从 => 服从
顺道 => 顺路
顺服 => 顺从制服
顺理成章 => 瓜熟蒂落
顺利 => 顺遂
顺其自然 => 天真烂漫
顺手 => 随手
顺俗 => 随俗
顺遂 => 顺利
顺序 => 次序
顺应 => 适应
瞬间 => 刹时
说长道短 => 说三道四
说话 => 措辞
说谎 => 撒谎
说明 => 解释
说明书 => 仿单
说情 => 讨情
说三道四 => 说长道短
说书 => 评话
说一是一 => 一言为定
硕大无朋 => 庞大无比
丝毫 => 涓滴
丝毫不爽 => 谬误百出
司库 => 管库
司理 => 经理
私函 => 便函
私货 => 黑货
私家 => 私人
私见 => 偏见
私情 => 私交
私人 => 私家
私人亲信 => 夹袋中人物
私下 => 暗里
私相授受 => 秘密交易
私意 => 私衷
私语 => 密语
私运 => 走私
私衷 => 私意
私自 => 擅自
思考 => 思虑
思量 => 考虑
思路 => 思绪
思念 => 怀念
思索 => 思考
思想 => 思惟
思绪 => 思路
厮混 => 胡混
厮闹 => 胡闹
厮役 => 苍头
撕裂 => 扯破
死 => 逝世
死板 => 呆板
死而复活 => 死去活来
死后 => 身后
死谏 => 尸谏
死里逃生 => 虎口余生
死路 => 绝路末路
死气 => 暮气
死去活来 => 死而复活
死生无惧 => 刀锯不辞
死生之交 => 啮臂之交
死亡 => 灭亡
死有余辜 => 死不足惜
死罪 => 极刑
四不像 => 怪样子
四季 => 四时
四六文 => 骈体文
四面楚歌 => 八面受敌
四通八达 => 七通八达
四行孤军 => 八百壮士
四序 => 四季
四周 => 周围
寺库 => 当铺
伺机 => 乘机
伺隙 => 俟机
似是而非 => 貌同实异
似义词 => 词目
饲养 => 豢养
驷不及舌 => 令出必行
俟机 => 伺隙
肆虐 => 残虐
肆无忌惮 => 毫无所惧
松弛 => 松懈
松懈 => 松弛
怂恿 => 鼓动
耸立 => 矗立
耸人听闻 => 骇人听闻
讼事 => 官司
送还 => 归还
送旧迎新 => 送往迎来
送命 => 送死
送上 => 奉上
送死 => 送命
搜刮 => 搜索
搜集 => 汇集
搜劫 => 抄掠
搜索 => 搜刮
搜索引擎优化 => seo
苏息 => 休息
苏醒 => 清醒
苏州 => 姑苏
俗不可耐 => 鄙俗不堪
俗气 => 庸俗
俗儒 => 陋儒
俗语 => 鄙谚
夙儒 => 老儒
夙世冤家 => 前世怨仇
夙夜匪懈 => 日夜勉
诉苦 => 抱怨
肃清 => 清除
肃然 => 寂然
素不相识 => 素昧生平
素交 => 故旧
素性 => 生性
素愿 => 素志
素志 => 素愿
素质 => 本质
速率 => 速度
宿病 => 旧病
宿将 => 老将
宿世 => 前世
宿债 => 旧债
宿帐 => 旧帐
塑像 => 泥像
酸楚 => 辛酸
酸心 => 痛心
算无遗策 => 计划精巧
算帐 => 清算计帐
算做 => 举动当作
虽然 => 固然
随笔 => 漫笔
随便 => 随意
随波逐流 => 同流合污
随处 => 到处
随从 => 侍从
随机应变 => 因时制宜
随侍 => 陪侍
随手 => 顺手
随同 => 伴随
随意 => 随便
随着 => 跟着
岁入 => 岁收
岁收 => 岁入
遂心如愿 => 称心快意
隧道 => 地道
损害 => 伤害
损坏 => 破坏
损伤 => 毁伤
损失 => 丧失
唆使 => 指示
所在 => 地点
所在多有 => 不一而足
琐屑 => 零碎
琐屑较量 => 斤斤计较
琐屑零星 => 鸡零狗碎
他日 => 异日
他山之石 => 参考之资
他乡 => 异域
他心 => 贰心
踏实 => 扎实
台端 => 大驾
台甫 => 大名
抬高 => 举高
抬头 => 昂首
太仓一粟 => 沧海微尘
太初 => 太始
太古 => 邃古
太过 => 太甚
太监 => 寺人
太平 => 宁靖
太平时世 => 清平世界
太甚 => 太过
太始 => 太初
太息 => 嗟叹
态度 => 立场
态度冷静 => 平心易气
态度严肃 => 正襟危坐
泰半 => 大半
泰平承平 => 升平平安
泰山其颓 => 泰山殒落
泰山压卵 => 狮子搏兔
泰西 => 西洋
坍毁 => 倾圯
贪杯 => 贪酒
贪官污吏 => 贪官蠹役
贪婪 => 贪心
贪吏 => 污吏
贪图 => 妄想
贪污舞弊 => 饮马投钱
贪心 => 贪婪
贪嘴 => 贪馋
摊平 => 铺平
昙花一现 => 好景不常
谈锋 => 口才
谈话会 => 茶话会
谈判 => 会谈
谈天 => 聊天
谈吐 => 辞吐
谈笑 => 说笑
谈笑风生 => 妙语横生
谈心 => 交心
覃思 => 沉思
檀案 => 档册
檀越 => 施主
忐忑不安 => 七上八下
坦白 => 坦率
坦怀相待 => 开心见诚
坦率 => 坦白
坦直 => 直爽
袒露 => 裸露
袒裼裸裎 => 寸丝不挂
袒自若 => 自得其乐
叹伤 => 悲叹
叹惋 => 叹惜
叹息 => 太息
叹惜 => 叹惋
探究 => 探讨
探亲 => 投亲
探求 => 寻找
探索 => 摸索
探讨 => 商量
探听 => 打听
探望 => 看望
探问 => 探听
探寻胜迹 => 访古寻幽
探询 => 探听
探询探望 => 打听
探友 => 访友
探员 => 捕快
堂而皇之 => 冠冕堂皇
堂兄弟 => 从兄弟
搪瓷 => 珐琅
搪塞 => 敷衍
螳臂挡车 => 蚍蜉撼树
倘若 => 倘使
倘使 => 假使
倘佯 => 徘徊
淌下 => 滴下
滔滔 => 滚滚
饕餮 => 贪吃
逃避 => 回避
逃出法网 => 逍遥法外
逃难 => 避祸
逃匿 => 窜匿
逃脱 => 逃走
逃亡 => 流亡
逃走 => 逃脱
陶然 => 欢然
陶醉 => 沉醉
淘气 => 调皮
淘汰 => 镌汰
讨伐 => 伐罪
讨饭 => 乞食
讨好 => 谄谀
讨教 => 叨教
讨救 => 请援
讨论 => 评论辩论
讨情 => 说情
讨饶 => 求饶
讨厌 => 憎恶
讨债 => 讨帐
特别 => 特殊
特别卖力 => 出力异常
特长 => 专长
特出 => 彪炳
特地 => 专程
特点 => 特色
特工 => 间谍
特立 => 挺拔
特色 => 特点
特殊 => 特别
特性 => 特征
特征 => 特点
疼痛 => 痛苦悲伤
腾飞 => 起飞
腾踊 => 腾跃
腾跃 => 腾踊
腾云驾雾 => 腾云跨风
誊录 => 誊写
誊写 => 誊录
啼饥号寒 => 饥寒交迫
啼哭 => 哭泣
啼声 => 叫声
啼笑皆非 => 哭笑不得
提拔 => 选拔
提倡 => 倡导
提防 => 防备
提高 => 进步
提供 => 供给
提及 => 说起
提升 => 晋升
提示 => 提醒
提携 => 扶携提拔
提心吊胆 => 心惊肉跳
提醒 => 提示
提要 => 提纲
题名 => 落款
题目 => 标题
体格 => 体魄
体会 => 领会
体例 => 编制
体谅 => 谅解
体面 => 面子
体魄 => 体格
体态 => 身形
体贴 => 体谅
体无完肤 => 遍体鳞伤
体系 => 系统
体现 => 表现
体制 => 体系体例
剃头 => 理发
涕泣 => 涕零
替换 => 调换
替人 => 替身
天保九如 => 反老回童
天禀 => 禀赋
天才横溢 => 才气纵横
天长地久 => 矢志不移
天愁地惨 => 鬼哭神号
天道好还 => 法网恢恢
天地 => 寰宇
天翻地覆 => 天崩地裂翻天覆地
天分 => 天禀
天赋 => 禀赋
天高气爽 => 秋高气爽
天公疼核 => 傻人有傻福
天国 => 天堂
天河 => 河汉
天花乱坠 => 信口开河
天昏地暗 => 昏天黑地
天经地义 => 理所当然
天井 => 庭院
天伦 => 嫡亲
天南地北 => 天南海北
天南海北 => 天南地北
天年 => 天算
天气 => 气象
天晴 => 晴和
天然 => 自然
天壤之别 => 天地之别
天生 => 生成
天算 => 天年
天孙 => 王孙
天台 => 晒台
天下 => 世界
天下归心 => 率土归心
天下升平 => 天下太平
天下一家 => 世界大同
天性 => 本性
天悬地隔 => 云泥之别
天涯 => 天际
天涯海角 => 海角天涯
天佑 => 天助
天造地设 => 神工鬼斧
天真 => 无邪
天真烂漫 => 顺其自然
天真未凿 => 浑金璞玉
天职 => 本分
天诛地灭 => 不得善终
天主 => 上帝
天助 => 天佑
天姿国色 => 国色天香
天子 => 皇帝
添补 => 填充
添油加醋 => 添枝接叶
添枝加叶 => 节外生枝
添枝接叶 => 添油加醋
田地 => 地步
田户 => 佃户
田鸡 => 青蛙
田契 => 田单
田舍 => 农家
田舍郎 => 农家子
田野 => 野外
田主 => 地主
恬不知耻 => 厚颜无耻
恬淡 => 澹泊
恬静 => 安静
甜美 => 甜蜜
甜蜜 => 甜美
甜睡 => 酣睡
甜言 => 蜜语
甜言蜜语 => 花言巧语
填补 => 弥补
忝在爱末 => 叨在知己
佻薄 => 浮滑
挑拨 => 挑唆
挑拨离间 => 搬弄是非
挑拨是非 => 弄狗相咬
挑夫 => 夫役
挑水 => 担水
挑唆 => 挑拨
挑剔 => 抉剔
挑衅 => 寻衅
挑选 => 遴选
挑战 => 挑衅
挑撰 => 拣选
挑 => 浮薄
条记 => 笔记
条件 => 前提
条款 => 条目
条理 => 层次
条理分明 => 头头是道
条文 => 条则
条约 => 合同
条子 => 便条
迢遥 => 遥远
蜩螗沸羹 => 虫鸣水沸
眺望 => 远望
跳班 => 跳级
跳出火炕 => 逃出生天
贴近 => 切近
贴题 => 切题
铁笔银钩 => 铁画银钩
铁画银钩 => 铁笔银钩
铁蒺藜 => 铁丝网
铁价 => 不二价
铁面无私 => 铁面无情
铁娘子 => 女强人
铁石心肠 => 木人石心
铁丝网 => 铁蒺藜
铁中铮铮 => 人中表表
帖服 => 服帖
听从 => 服从
听凭 => 任凭
听其自然 => 听天由命
听说 => 据说
听天由命 => 任天由命
庭院 => 天井
停笔 => 搁笔
停步 => 留步
停车 => 泊车
停当 => 就绪
停顿 => 停留
停留 => 逗留
停息 => 暂停
停业 => 休业
停战 => 休战
停止 => 停滞
停滞 => 停止
停滞不前 => 裹足不前
挺拔 => 挺立
挺立 => 挺拔
挺身而出 => 自告奋勇
挺秀 => 挺拔
铤而走险 => 官逼民反
通报 => 传递
通常 => 平日
通畅 => 通行
通达 => 通晓
通告 => 公告
通过 => 经由过程
通合一气 => 通同一气
通力合作 => 共同努力
通力进行 => 携手合作
通例 => 惯例
通盘 => 全盘
通情达理 => 合情合理
通商 => 互市
通书 => 历本
通同一气 => 沆瀣一气
通同作恶 => 朋比为奸
通宵 => 彻夜
通宵达旦 => 焚膏继晷
通信 => 通讯
通讯 => 通信
通译员 => 翻译员
通则 => 公则
同伴 => 错误
同辈 => 平辈
同出一脉 => 同宗同气
同窗 => 同学
同窗夜语 => 剪烛西窗
同床异梦 => 貌合神离
同道 => 同志
同等 => 一致
同等看待 => 比量齐观
同甘共苦 => 安危与共
同流合污 => 与世浮沉
同盟 => 联盟
同命鸳鸯 => 患难夫妻
同谋 => 合谋
同气连枝 => 手足同心
同亲 => 同乡
同乡 => 同亲
同心 => 齐心
同心并力 => 协力同心
同心同德 => 一心一德
同心专心 => 一心
同行 => 同业
同学 => 同窗
同砚 => 同学
同一 => 统一
同意 => 赞成
同寅 => 同僚
同舟共济 => 志同道合
同族 => 本家
彤霞 => 红霞
彤云 => 浓云
铜漏滴尽 => 更鼓敲尽
铜墙铁壁 => 金城汤池
铜山 => 宝穴
童叟无欺 => 老少无欺
童言无忌 => 百无禁忌
童谣 => 儿歌
童贞 => 处女
童子 => 孺子
统筹 => 兼顾
统共 => 总共
统领 => 管辖
统统 => 一切
统辖 => 总揽
统一 => 同一
痛爱 => 宠爱
痛澈心脾 => 心如刀割
痛楚 => 苦楚
痛处 => 把柄
痛恨 => 仇恨
痛苦 => 苦楚
痛苦悲伤 => 疼痛
痛快 => 愉快
痛快酣畅 => 舒坦
痛骂 => 大骂
痛惜 => 怅然
痛心疾首 => 咬牙切齿
痛痒相关 => 休戚相关
痛饮 => 猛饮
偷安 => 苟安
偷盗 => 偷窃
偷换 => 掉包
偷窥 => 窃视
偷窃 => 偷盗
偷取 => 盗取
偷天换日 => 批红判白
偷偷的 => 悄悄的
偷偷摸摸 => 鬼鬼祟祟
偷袭 => 狙击
头等 => 优等
头角峥嵘 => 高人一等
头领 => 首级头目
头目 => 头子
头脑 => 脑筋
头童齿豁 => 蓬头历齿
头陀 => 梵衲
投奔 => 投靠
投笔从戎 => 弃文就武
投刺 => 进谒
投递 => 送达
投合 => 逢迎
投机 => 投契
投机取巧 => 脚踏两船
投降 => 屈膝投降
投军 => 当兵
投靠 => 投奔
投桃报李 => 礼尚往来
投止 => 寄宿
投掷 => 扔掷
透辟 => 透彻
透彻 => 透辟
透澈 => 澈底
透风 => 通风
透骨 => 砭骨
透露 => 泄漏
秃笔 => 拙笔
秃顶 => 光头
秃头 => 秃顶
突出 => 凸起
突破 => 冲破
突起 => 崛起
突然 => 忽然
突入 => 冲入
图画 => 丹青
图利 => 牟利
图书馆 => 藏书楼
图章 => 钤记
徒弟 => 门徒
徒然 => 枉然
荼毒 => 虐待
途经 => 路过
途径 => 门路
屠狗之辈 => 市井之徒
屠戮 => 屠杀
屠杀 => 屠戮
屠烧 => 焚杀
土崩瓦解 => 风声鹤唳
土产 => 本地货
土地 => 地盘
土匪 => 匪贼
土鸡瓦犬 => 土牛木马
土气 => 土头土脑
土壤 => 泥土
土人 => 土着土偶
土头土脑 => 土气
吐刚茹柔 => 欺软怕硬
吐故纳新 => 弃旧容新
吐露 => 流露
吐逆 => 呕吐
兔死狗烹 => 鸟尽弓藏
兔脱 => 逃窜
团结 => 联结
团体 => 集团
团鱼 => 甲鱼
团圆 => 团聚
推波助澜 => 火上浇油
推测 => 推想
推崇 => 推重
推辞 => 推脱
推戴 => 拥戴
推动 => 推进
推断 => 揣摸
推翻 => 颠覆
推荐 => 推举
推进 => 推动
推举 => 推荐
推门 => 排闼
推拿 => 按摩
推敲 => 斟酌
推求 => 推寻
推却 => 辞谢
推让 => 谦让
推涛作浪 => 挑拨离间
推脱 => 推辞
推销 => 倾销
推卸 => 推辞
推心置腹 => 贴心贴腹
推行 => 履行
推许 => 推重
推选 => 推荐
推重 => 推许
颓败 => 衰颓
颓废 => 颓丧
颓龄 => 衰年
颓丧 => 颓废
退兵 => 退军
退军 => 退兵
退却 => 撤退
退让 => 让步
退席 => 离席
退役还乡 => 解甲归田
蜕变 => 演变
蜕化 => 堕落
吞并 => 兼并
吞没 => 淹没
吞声忍气 => 不敢则声
吞吐其词 => 含混其词
吞吐其辞 => 吞吞吐吐
屯子 => 农村
托病 => 称疾
托钵 => 讨饭
托钵人 => 乞丐
托词 => 藉词
托辞 => 假称
托付 => 拜托
托故 => 藉端
托身 => 寄身
托言 => 饰辞
托之空言 => 徒托空言
托足 => 寄迹
拖沓 => 拖拉
拖拉 => 拖沓
拖麻拽布 => 披麻带孝
拖泥带水 => 滞滞泥泥
拖延 => 迁延
脱稿 => 完稿
脱离 => 离开
脱期 => 宽限
脱手 => 出手
脱险 => 出险
脱销 => 畅销
酡颜 => 脸红
妥当 => 妥善
妥善 => 妥当
妥贴 => 就绪妥当
妥帖 => 妥当
妥协 => 让步
椭圆形 => 卵形
拓荒 => 垦荒
唾骂 => 咒骂
唾面自干 => 逆来顺受
唾弃 => 鄙弃
挖掘 => 发掘
挖苦 => 奚落
洼地 => 凹地
瓦解 => 崩溃
歪路 => 旁门
歪七扭八 => 歪歪扭扭
歪曲 => 曲解
外传 => 别传
外地 => 外埠
外号 => 绰号
外祸 => 外患
外家 => 娘家
外交 => 交际
外貌 => 表面
外强中干 => 虚有其表
外侨 => 侨民
外氏 => 舅家
外套 => 外衣
外温内厚 => 厚貌深情
外行人 => 门外汉
外扬 => 传扬
外洋 => 海外
外衣 => 外套
外助 => 外援
外族 => 异族
弯曲 => 曲折
弯弯曲曲 => 曲曲折折
弯腰 => 哈腰
纨子弟 => 公子王孙
完备 => 完整
完场 => 拆档
完蛋 => 垮台
完工 => 落成
完好 => 无缺
完婚 => 结婚
完满 => 美满
完美 => 完善
完美无缺 => 十全十美
完全 => 完整
完善 => 完美
完整 => 完全
玩法 => 弄法
玩笑 => 打趣
顽固 => 固执
顽固不化 => 至死不悟
顽疾 => 恶疾
顽强 => 倔强
顽躯 => 贱体
宛如 => 好像
宛在目前 => 栩栩如生
宛转 => 委宛
挽救 => 抢救
晚景 => 暮景暮年
晚世 => 近世
婉转 => 悠扬
惋惜 => 可惜
万古长青 => 流芳千古
万能 => 全能
万试万灵 => 功效如神
万万 => 切切
万无一失 => 满有把握
万众一心 => 举国同心
腕表 => 手表
亡命 => 流亡
王法 => 国法
王侯 => 贵爵
王侯将相 => 达官贵人
王老五骗子 => 光棍
王孙 => 天孙
王孙公子 => 贵族子弟
王谢 => 望族
网罗密布 => 天罗地网
网络 => 收集
网鱼 => 捕鱼
往复 => 来去
往事 => 旧事
枉费 => 白费
枉费心机 => 白费心血
枉驾 => 屈驾
罔顾情面 => 打狗不看主人面
惘然 => 怅惘
妄图 => 妄想
妄想 => 妄图
妄语 => 妄言
忘八 => 混蛋
忘八乌龟无赖 => 绿头巾
忘恩负义 => 利令智昏
忘怀 => 忘记
忘记 => 忘却
忘却 => 忘记
忘我 => 无私
忘形 => 失态
旺盛 => 兴旺
望尘莫及 => 瞠乎其后
望而生畏 => 望而却步
望见 => 瞥见
望眼将穿 => 望穿秋水
望远镜 => 千里镜
危害 => 伤害
危急 => 危机
危如累卵 => 累卵之危
危坐 => 端坐
威逼 => 威胁
威德兼施 => 宽猛相济
威风凛凛 => 气势
威望 => 威信
威武不屈 => 坚毅不拔
威吓 => 恐吓
威胁 => 威逼
威信 => 威望
微薄 => 菲薄
微不足道 => 眇乎小哉
微风 => 轻风
微贱 => 卑微
微妙 => 奥妙
微时之交 => 布衣之交
微暇 => 寸
微小 => 渺小
为虎傅翼 => 如虎添翼
为难 => 难堪
为人作嫁 => 依人篱下
为所欲为 => 随心所欲
围巾 => 领巾
围绕 => 环绕
违背 => 违反
违反 => 违背
违禁 => 犯禁
违抗 => 违背
违逆 => 忤逆
唯命是听 => 敬谨如命
唯一 => 独一
维持 => 保持
维持原状 => 依样葫芦
维护 => 保护
伟大 => 巨大
伟人 => 巨人
伪钞 => 假票
伪造 => 捏造
伪装 => 假装
尾月 => 腊月
委顿 => 疲劳
委果 => 委的
委决不下 => 难以决断
委曲 => 委屈
委曲求全 => 含垢忍辱
委宛 => 宛转
萎靡不振 => 精神萎顿
猥贱 => 卑贱
猥琐 => 鄙陋
卫护 => 戍卫
未便 => 不便
未定 => 不决
未定之天 => 前途难料
未几 => 不久不多
未可厚非 => 无可非议
未来 => 将来
未免 => 不免难免
未入流 => 不够格
未亡人 => 寡妇
未曾 => 不曾
位置 => 地位
畏惧 => 害怕
畏妻如虎 => 河东狮吼
畏怯 => 胆怯
畏罪 => 惧罪
喂养 => 豢养
猬集 => 丛集
慰藉 => 安慰
慰劳 => 慰问
慰问 => 慰劳
温和 => 平和
温暖 => 暖和
温柔 => 温顺
温顺 => 温柔
温文尔雅 => 文质彬彬
温习 => 复习
文案 => 案牍
文定 => 订婚
文籍 => 典籍
文静 => 娴静
文句 => 词句
文体 => 体裁
文雅 => 高雅
文移 => 公牍
文意 => 辞意
文质彬彬 => 温文尔雅
闻达 => 显达
闻风而动 => 闻风远扬
闻风而逃 => 闻风而动
闻风丧胆 => 心惊胆战
闻名 => 著名
闻一知十 => 举一反三
刎颈交 => 生死之交
紊乱 => 杂乱
稳操胜券 => 可操左券
稳定 => 稳固
稳固 => 稳定
稳扎稳打 => 步步为营
稳重 => 庄重
问鼎 => 染指
问心无愧 => 心安理得
瓮中鳖 => 囊中物
蜗角之争 => 蛮触之争
我见犹怜 => 楚楚可怜
沃田 => 肥田
沃土 => 膏壤
握别 => 告别
龌龊 => 肮脏
乌鸟私情 => 慈乌反哺
污吏 => 贪吏
污流 => 浊流
污蔑 => 歪曲
污名 => 臭名
污浊 => 浑浊
呜咽 => 哭泣
屋子 => 房子
诬告 => 诬陷
诬蔑 => 诽谤
诬陷 => 诬告
无边无涯 => 无边无际
无地自容 => 愧汗怍人
无端 => 无故
无法动弹 => 寸步难移
无法复生 => 回天乏术
无法计算 => 难以估计
无关紧要 => 可有可无
无价之宝 => 价值千金
无可非议 => 未可厚非
无赖 => 恶棍
无能为力 => 力所不及
无穷 => 无限
无视 => 疏忽
无私 => 忘我
无妄之灾 => 池鱼之殃
无限 => 无穷
无一生还 => 全军尽没
无意偶尔 => 偶然
无知 => 蒙昧
无足挂齿 => 不足介意
无阻畅通 => 畅通无阻
毋须着急 => 不用着急
五彩缤纷 => 花团锦簇
五花八门 => 八门五花
五十步笑百步 => 龟笑鳖无尾
五月 => 蒲月
妩媚 => 娇媚
武备 => 军备
武断 => 果断
武器 => 兵器
武士 => 军人
武术 => 技击
武艺 => 技艺
侮慢 => 轻渎
侮辱 => 凌辱
舞蹈 => 跳舞
物质 => 物资
物资 => 物质
误会 => 误解
误解 => 误会
误事出事 => 失事
晤面 => 见面
雾里看花 => 若明若暗
夕阳 => 斜阳
西化 => 欧化
西席 => 教师
西岳 => 华山
西崽 => 仆役
吸风饮露 => 沐雨栉风
吸取 => 汲取
吸收 => 接收
吸血虫 => 剥削者
吸烟 => 抽烟
希罕 => 希奇
希奇 => 希罕
希望 => 愿望
昔不如今 => 今是昨非
昔人 => 古人
昔日 => 往日
奚落 => 挖苦
息兵 => 停战
息款 => 息钱
息息相关 => 互相关注
息息相通 => 心心相印
息争 => 和解
牺牲 => 就义
悉索敝赋 => 倾尽国库
犀利 => 锋利
稀罕 => 奇怪
稀奇古怪 => 八怪七喇
稀少 => 稀疏
稀疏 => 稀少
稀有 => 罕见
嘻皮笑脸 => 油腔滑调
嬉皮笑脸 => 喜笑颜开
嬉戏 => 游玩
膝行 => 匍匐
习气 => 习惯
习性 => 习惯
习用 => 惯用
席卷 => 囊括
袭取 => 剿袭
洗擦 => 刷洗
洗耳恭听 => 倾耳细听
洗净铅华 => 反璞归真
洗礼 => 浸礼
洗面革心 => 改头换面
洗沐 => 冲凉
洗手不干 => 脱胎换骨
洗心革面 => 改过自新
洗雪 => 湔雪
洗浴 => 沐浴
洗濯 => 清洗
喜爱 => 爱好
喜报 => 捷报
喜好 => 爱好
喜欢 => 爱好
喜笑颜开 => 嬉皮笑脸
喜新厌旧 => 见异思迁
喜信 => 喜讯
喜讯 => 喜信
戏班 => 梨园
戏剧演员 => 梨园子弟
戏弄 => 辱弄
戏院 => 剧场
戏子 => 伶人
系缚 => 捆扎
系念 => 牵挂捆扎
系统 => 体系
细长 => 修长
细密 => 精密
细软 => 金饰
细听 => 谛听
细小 => 渺小
细心 => 仔细
细姨 => 小老婆
细致 => 过细
瞎搅 => 乱来
瞎说 => 瞎扯
瞎眼 => 盲眼
狭小 => 狭窄
狭窄 => 狭小
遐龄 => 高寿
遐想 => 联想
下层 => 基层
下等 => 劣等
下贱 => 下流
下降 => 降低
下令 => 命令
下流 => 下贱
下午 => 下昼
下游 => 下流
下狱 => 坐牢
下战书 => 下午
下属 => 部属
吓唬 => 恫吓
夏布 => 麻布
夏季 => 夏日
夏历 => 农历
夏日 => 夏季
夏天 => 炎天
罅漏 => 缺漏
仙丹 => 灵药
仙风道骨 => 品格清高瘦骨如柴
仙颜 => 美貌
仙游 => 升天
先辈 => 前辈
先锋 => 前锋
先进 => 先辈
先驱 => 前驱
先人 => 祖先
先容 => 介绍
先生 => 师长教师
先兆 => 预兆
先哲 => 前贤
纤尘不染 => 一尘不染
掀开 => 翻开
鲜花易谢 => 好事多磨
鲜丽 => 辉煌光耀
鲜明 => 光鲜
鲜味 => 美味
鲜衣美食 => 华衣美食
闲步 => 漫步
闲雅 => 娴雅
闲言闲语 => 蜚短流长
闲云野鹤 => 袒自若
闲坐 => 枯坐
弦外之音 => 意在言外
贤达 => 贤能
贤明 => 英明
贤能 => 贤良
贤人 => 圣人
咸宜 => 皆宜
娴静 => 文静
衔接 => 连接
衔命 => 奉命
显贵 => 权贵
显露表露 => 流露透露
显明 => 明显
显现 => 浮现
显著 => 明显
显着 => 明显
险恶 => 邪恶
险路 => 险途
险些 => 几乎
险要 => 险峻
现实 => 实际
现在 => 如今
现状 => 近况
线人 => 耳目
限定 => 限制
限期 => 限日
陷害 => 谗谄
陷落 => 沦陷
羡慕 => 爱慕
乡村 => 村庄
乡间 => 乡下
乡人 => 村夫
乡俗 => 土风
乡下 => 乡间
乡信 => 家书
芗泽 => 芳泽
相安无事 => 息事宁人
相比 => 比拟
相称 => 相当
相逢 => 重逢
相干 => 相关
相关 => 相干
相互 => 互相
相继 => 接踵
相见恨晚 => 相知恨晚
相交 => 订交
相近 => 邻近
相敬如宾 => 举案齐眉
相貌 => 边幅
相生相克 => 恶马恶人骑
相识 => 了解
相似 => 类似
相同 => 雷同
相信 => 信任
相沿 => 因袭
相宜 => 适宜
相应 => 响应
相知恨晚 => 相见恨晚
相助 => 互助
香 => 喷鼻
香肠 => 腊肠
香馥馥 => 香喷喷
香喷喷 => 香馥馥
香烟 => 卷烟
厢房 => 配房
详目 => 细目
详确 => 详实
详述 => 胪陈
详细 => 具体
祥瑞 => 吉祥
享福 => 纳福
响亮 => 洪亮
想法 => 设法主意
想念 => 惦念
向导 => 领导
向来 => 素来
向荣 => 茂发
向往 => 神往
向阳 => 朝阳
巷子 => 小路
象齿焚身 => 怀璧其罪
削弱 => 减弱
削足就履 => 截趾适履
枵腹 => 空腹
消沉 => 低沉
消除 => 清除
消防员 => 救火员
消费 => 花费
消耗 => 消费
消灭 => 祛除
消灭净尽 => 鸡犬不留
消散 => 消失
消失 => 消逝
消逝 => 消失
消瘦 => 瘦削
消亡 => 灭亡
消息 => 新闻
逍遥法外 => 逃出法网
萧规曹随 => 率由旧章
萧墙之祸 => 家庭祸变
销毁 => 烧毁
销魂 => 断魂
销声匿迹 => 鸣金收兵
销售 => 发卖
小船 => 划子
小大由之 => 可大可小
小肚鸡肠 => 鼠肚鸡肠
小儿百姓 => 赤子
小房 => 斗室
小节 => 末节
小姐 => 蜜斯
小扣 => 轻敲
小路 => 巷子
小名 => 奶名
小气 => 吝啬
小人得志 => 瓦釜雷鸣
小手小脚 => 计无所出
小我私家 => 个人
小巷 => 冷巷
小心 => 当心
小心翼翼 => 战战兢兢
小星 => 细姨
小序 => 弁言
小引 => 短序
小雨 => 细雨
小坐 => 略坐
晓风 => 晨风
孝服 => 凶服
孝敬 => 孝顺
孝顺 => 孝敬
效法 => 师法
效果 => 后果
效力 => 效率
效率 => 效力
效忠 => 尽忠
校订 => 校正
校对 => 校订
校阅 => 检阅校对
校阅阅兵 => 检阅
校正 => 校订
笑哈哈 => 笑嘻嘻
笑剧 => 喜剧
笑脸 => 笑容
笑貌 => 笑容
笑容 => 笑颜
笑颜 => 笑容
笑逐颜开 => 喜逐颜开
歇工 => 停工
歇手 => 罢手
歇息 => 安歇
协调 => 调和
协定 => 协议
协力 => 合力
协议 => 协定
协议同意 => 和议
邪恶 => 险恶
邪路 => 歧途
邪念 => 杂念
邪术 => 魔法
胁迫 => 钳制
挟恨 => 怀恨
挟制 => 劫持
偕行 => 同行
斜阳 => 夕阳
谐谑 => 调笑
携手 => 联袂
携同 => 带同
写意 => 适意
泄电 => 漏电
泄漏 => 泄露
泄漏天机 => 透露机密
泄露 => 泄漏
亵服 => 内衣
谢绝 => 拒绝
谢谢 => 感谢
谢罪 => 赔罪
邂逅 => 相逢
心安理得 => 问心无愧
心病 => 芥蒂
心裁 => 机杼
心肠 => 心地
心胆俱寒 => 胆破心惊
心地 => 心肠
心烦意乱 => 心乱如麻
心腹 => 亲信
心甘情愿 => 毫不勉强
心高气傲 => 骄气十足
心怀叵测 => 包藏祸心
心机 => 心计心情
心境 => 心情
心坎 => 心田
心口不一 => 言不由衷
心里有数 => 冷暖自知
心乱如麻 => 心烦意乱
心满意足 => 得偿所愿
心平气和 => 平心静气
心情 => 心境
心曲 => 襟曲
心如乱麻 => 盘根错节
心伤 => 心酸
心神不定 => 犹豫不决
心事 => 苦衷
心算 => 默算
心田 => 心坎
心痛 => 肉痛
心心相印 => 心领神会
心胸 => 气量气度
心血 => 血汗
心余力绌 => 汲深绠短
心猿意马 => 心神恍惚
心悦诚服 => 甘拜下风
心折 => 心服
心醉情移 => 色授魂与
忻忭 => 欢忻
辛苦 => 辛劳
辛劳 => 辛苦
辛勤 => 辛苦
欣赏 => 观赏
新居 => 新房
新力量 => 生力军
新苗 => 嫩芽
新奇 => 别致
新闻 => 消息
新鲜 => 新颖
新颖 => 新鲜
薪尽火灭 => 一刀两断
信奉 => 信仰
信服 => 佩服
信号 => 旌旗灯号
信赖 => 信任
信念 => 信心
信任 => 信赖
信托 => 信任
信心 => 信念
信仰 => 崇奉
信用 => 信誉
信誉 => 信用
兴兵 => 发兵
兴废 => 荣枯
兴奋 => 高兴
兴高采烈 => 兴致勃勃
兴尽悲来 => 乐极生悲
兴起 => 鼓起
兴趣 => 兴致
兴盛 => 隆盛
兴旺 => 旺盛
兴致 => 兴趣
兴致索然 => 兴味索然
星火燎原 => 燎原之火
星期 => 礼拜
星期日 => 日曜日
星期四 => 木曜日
惺惺相惜 => 同病相怜
刑场 => 法场
刑罚 => 科罚
刑警队 => 侦缉队
行刺 => 谋杀
行动 => 行为
行贿 => 贿赂
行家 => 内行
行将就木 => 风烛残年
行径 => 行动
行礼 => 施礼
行列步队 => 队列
行善 => 积德
行同狗彘 => 人面兽心
行为 => 行动
行侠仗义 => 抱不平
行运 => 交运
行止 => 去处
行踪飘忽 => 出没无定
形单影只 => 孑然一身
形格势禁 => 格于环境
形貌 => 描写
形容枯槁 => 形销骨立
形式 => 情势
形态体式 => 格式方式
形影相吊 => 孓然一身
形影相随 => 形影不离
形状 => 外形
醒目 => 能干
醒悟 => 觉悟
杏眼圆睁 => 柳眉倒竖
幸不辱命 => 不辱使命
幸亏 => 亏得
幸运 => 荣幸
性格 => 性情
性命 => 生命
性能 => 机能
性情 => 性格
性子 => 性质
凶暴 => 凶狠
凶恶 => 凶狠
凶服 => 孝服
凶悍 => 凶猛
凶狠 => 凶恶
凶猛 => 凶悍
凶险 => 阴险
凶相 => 恶相
凶讯 => 凶信
兄弟阋墙 => 骨肉相残
兄弟相斗 => 豆箕相煎
汹涌 => 澎湃
汹涌澎拜 => 风起云涌
汹涌澎湃 => 波澜壮阔
胸怀 => 襟怀胸襟
胸膜 => 肋膜
胸无点墨 => 目不识丁
胸有定见 => 心中有数
胸中有数 => 胸有成竹
雄浑 => 雄壮
雄健 => 雄壮
雄赳赳 => 气昂昂
雄师 => 大军
雄伟 => 宏伟
雄心 => 大志
雄心勃勃 => 雄心壮志
雄心万丈 => 壮志凌云
雄心壮志 => 雄心勃勃
雄壮 => 雄浑
休咎 => 吉凶
休戚相关 => 风雨同舟
休憩 => 憩息
休息 => 歇息
休业 => 停业
修长 => 细长
修改 => 修正
修建 => 建筑
修理 => 补缀
修睦 => 修好
修缮 => 补葺
修饰 => 润饰
修养 => 教养
修业 => 求学
修正 => 修改
修筑 => 构筑
羞耻 => 羞辱
羞人答答 => 娇羞答答
羞辱 => 耻辱
羞涩 => 羞怯
朽迈 => 衰老
秀气 => 清秀
秀士 => 才人
绣花枕头 => 羊质虎皮
袖手旁观 => 作壁上观
袖中神算 => 锦囊妙计
须生 => 老生
须要 => 需要
须臾 => 转瞬
顼首 => 泥首
虚假 => 虚伪
虚弱 => 衰弱
虚伪 => 虚假
虚有其表 => 色厉内荏
虚与委蛇 => 假意周旋
需要 => 须要
墟落 => 乡村
墟市 => 市集
徐徐 => 渐渐
许多 => 很多
许可 => 允许
许诺 => 承诺
栩栩如生 => 维妙维肖
序次 => 次序
叙旧 => 话旧
叙述 => 论述
畜生 => 牲畜
絮聒 => 唠叨
絮絮叨叨 => 絮絮不休
宣布 => 宣告
宣称 => 传播鼓吹
宣传 => 宣扬
宣告 => 宣布
宣扬 => 宣传
喧宾夺主 => 鹊巢鸠占
喧华 => 嘈杂
喧哗 => 鼓噪
喧闹 => 闹热热烈繁华
喧嚣 => 喧哗
喧笑 => 哗笑
玄门 => 道教
玄妙 => 微妙
玄色 => 黑色
玄学 => 形而上学
玄月 => 九月
悬挂 => 吊挂
悬梁 => 吊颈
悬赏 => 赏格
悬想 => 揣想
悬崖 => 绝壁
悬崖勒马 => 回头是岸
旋里 => 回乡
旋转 => 扭转
选拔 => 提拔
选录 => 节录
选派 => 遴派
选取 => 拔取
炫耀 => 夸耀
绚烂 => 残暴
绚丽 => 壮丽
渲染 => 衬着
穴见 => 肤见
穴居 => 洞居
穴居野处 => 巢木居野
学费 => 膏火
学富五车 => 立地书橱
学堂 => 私塾
学习 => 进修
学校 => 黉舍
鷽鸠笑鹏 => 井蛙语海
雪恨 => 雪耻
雪窖冰天 => 冰天雪地
雪上加霜 => 落井下石
雪中送炭 => 济困解危
血汗 => 心血
血流成河 => 血流漂杵
血气之勇 => 匹夫之勇
血肉横飞 => 伤亡枕藉
血色 => 赤色
血虚 => 贫血
血战 => 决战苦战
熏风 => 南风
熏染 => 感染
熏陶 => 陶冶
寻常 => 平常
寻花问柳 => 拈花惹草
寻求 => 追求
寻思 => 沉思
寻衅 => 挑衅
巡查 => 巡视
巡察 => 梭巡
巡回剧团 => 旅行剧团
巡视 => 巡查
旬日 => 十日
驯伏 => 帖伏
驯服 => 征服
询问 => 讯问
循分 => 安分
循规蹈矩 => 循序渐进
循环 => 轮回
训练 => 练习
讯断 => 判决
讯问 => 询问
迅速 => 敏捷
徇情枉法 => 徇私舞弊
徇私舞弊 => 徇情枉法
逊色 => 减色
逊位 => 退位
逊谢 => 谦谢
压倒 => 压服
压倒一切 => 首屈一指
压服 => 胜过
压迫 => 榨取
压缩 => 紧缩
压抑 => 压制
压制 => 压抑
压轴好戏 => 好酒沉瓮底
鸦雀无声 => 阒寂无声
鸭蛋虽密也有缝 => 百密一疏
牙白口清 => 口齿伶俐
牙婆 => 媒婆
芽菜 => 豆芽
哑忍 => 隐忍
雅观 => 美观
雅致 => 高雅
亚肩迭背 => 肩摩毂击
烟火 => 炊火
烟消火灭 => 风流云散
淹没 => 吞没
淹没消灭 => 泯没
淹灭 => 泯灭
阉人 => 宦官
腌臜 => 污秽
延长 => 延伸
延接 => 款接
延揽兜揽 => 抖揽
延伸 => 延长
延误 => 耽搁
严防 => 谨防
严格 => 严厉
严峻 => 严格
严酷 => 严格
严厉 => 严格
严密 => 周密
严明 => 严正
严容 => 厉色
严肃 => 严正
严刑 => 酷刑
严阵以待 => 盛食厉兵
严正 => 严肃
妍媸 => 美丑
言不尽意 => 书不宣意
言传身教 => 上行下效
言而不信 => 食言而肥
言而不行 => 光说不做
言论 => 谈吐
言三语四 => 信口雌黄
言笑 => 谈笑
言犹在耳 => 口血未干
言语无味 => 面目可憎
岩穴 => 山洞
沿门托钵 => 吹箫吴市
炎火 => 烈焰
炎天 => 夏天
研究 => 研讨
研讨 => 研究
颜色 => 色彩
偃蹇困穷 => 命运坎坷
偃旗息鼓 => 消声匿迹
掩蔽 => 遮蔽
掩藏 => 遮蔽
掩盖 => 掩饰
掩护 => 保护
掩饰 => 掩盖
掩饰笼罩 => 掩盖
掩罪藏恶 => 文过饰非
眼光 => 眼力
眼花 => 目眩
眼花撩乱 => 目迷五色
眼见 => 目击
眼力 => 眼光
眼前 => 面前
眼去眉来 => 眉目传情
眼珠 => 眸子
演变 => 演化
演出 => 表演
演化 => 演变
演练 => 练习训练
演武厅 => 检阅场
演奏 => 吹奏
厌烦 => 腻烦
厌旧喜新 => 喜新厌旧
宴客 => 请客
艳服 => 盛装
雁足传书 => 鱼雁不绝
餍饫 => 饱食
餍足 => 满足
燕服 => 便服
燕尾服 => 大礼服
燕徙 => 乔迁
赝品 => 假货
央求条件 => 请求恳求
央央大度 => 宽洪大度
扬名 => 立名
扬弃 => 抛弃
扬声恶骂 => 破口大骂
扬汤止沸 => 救火投薪
扬扬得意 => 吐气扬眉
羊肠小道 => 曲折小路
羊毫 => 毛笔
阳关三迭 => 骊歌高唱
阳间 => 阳世
阳世 => 阳间
洋火 => 磷寸
洋蜡 => 白蜡
洋装 => 西服
仰面 => 抬头
仰慕 => 敬慕
仰人鼻息 => 举夺由人
仰食 => 仰给
仰望 => 瞻仰
仰药 => 服毒
养成工 => 练习生
养分 => 营养
养虎伤身 => 养痈遗患
养虎遗患 => 姑息养奸
养活 => 赡养
养生 => 摄生
养痈成患 => 养虎遗患
养痈遗患 => 养痈成患
样子容貌 => 模样
妖怪 => 魔鬼
妖言惑众 => 诡辞欺世
妖冶 => 明媚
妖装 => 盛饰
殽杂 => 混淆
谣传 => 讹传
谣言 => 流言
摇摆 => 扭捏
摇荡 => 摇曳
摇动 => 动摇
摇晃 => 摇摆
摇钱树 => 钱树子
摇尾乞怜 => 乞哀告怜
瑶池 => 仙境
杳如黄鹤 => 去如黄鹤
杳无音信 => 泥牛入海
杳杳无踪 => 鸿飞冥冥
咬文嚼字 => 句斟字嚼
药到病除 => 华陀再世
药到回春 => 妙手回春
药剂师 => 配药师
要冲 => 冲要
要地本地 => 内陆
要害 => 关键
要津 => 枢路
要领 => 方法
要求 => 请求
要是 => 如果
要挟 => 威胁
鹞子 => 风筝
耀眼 => 刺眼
揶揄 => 嘲弄
冶坊 => 炼坊
冶艳 => 浓艳
冶游 => 嫖妓
野鹤闲云 => 山林隐士
野猎 => 田猎
野蛮 => 蛮横
野史 => 别史
业绩 => 事迹
业务 => 营业
夜阑人静 => 更深人静
腋臭 => 狐臭
一败涂地 => 狼奔豕突
一壁 => 一面
一尘不染 => 一乾二净
一筹莫展 => 束手无策
一触即发 => 剑拔弩张
一得之愚 => 一孔之见
一点不错 => 分毫不爽
一定 => 必定
一个钱打二十四个结 => 精打细算
一呼百诺 => 前呼后拥
一呼百应 => 一呼百诺
一挥而就 => 一蹴而就
一箭双鵰 => 两全其美
一举而竟全功 => 毕其功于一役
一孔之见 => 一知半解
一口咬定 => 矢口不移
一览无余 => 一目了然
一连 => 连续
一鳞半爪 => 片纸只字
一落千丈 => 江河日下
一毛不拔 => 爱财如命
一目十行 => 目下十行
一男半女 => 寸男尺女
一起 => 一路
一气呵成 => 趁热打铁
一钱不受 => 分文不取
一乾二净 => 六根清净
一窍不通 => 一无所知
一清二楚 => 一览无余
一丘之貉 => 全无分别
一人得道 => 鸡犬升天
一日千里 => 进步神速
一扫而空 => 一网打尽
一生 => 平生
一声不响 => 一言不发
一石二鸟 => 一举两得
一时哄动 => 哄传一时
一矢之地 => 弹丸之地
一塌糊涂 => 乌烟瘴气
一统天下 => 金瓯无缺
一往直前 => 百折不回
一无长物 => 别无长物
一无可取 => 一无是处
一无是处 => 一无可取
一无所得 => 一无所获
一无所获 => 一无所得
一无所知 => 一窍不通
一下子 => 一会儿
一向 => 一贯
一笑置之 => 付之一笑
一心 => 同心专心
一言九鼎 => 出言如山
一言为定 => 说一是一
一样平常 => 一般
一叶知秋 => 尝鼎一
一意孤行 => 独行其是
一语道破 => 提纲挈领
一语而解 => 片言立决
一再 => 几回再三
一针见血 => 言必有中
一枝独秀 => 桂林一枝
一直 => 一向
一掷千金 => 挥金如土
伊于胡底 => 如何了局
衣冠禽兽 => 沐猴而冠
衣食计 => 稻粱谋
衣饰 => 服饰
医生 => 大夫
医院 => 病院
依附 => 依靠
依据 => 根据
依靠 => 依附
依赖 => 依附
依恋 => 迷恋
依依不舍 => 恋恋不舍
依照 => 按照
仪式 => 典礼
夷狄 => 蛮夷
夷易 => 平易
夷由 => 犹豫
怡然自得 => 悠然自得
姨妈 => 阿姨
贻害不浅 => 害人不浅
贻笑大方 => 见笑于人
胰子 => 肥皂
移船就磡 => 移樽就教
移多补少 => 截长补短
移祸 => 嫁祸
遗漏 => 漏掉
遗弃 => 抛弃
遗体 => 尸体
遗言 => 遗嘱
遗愿 => 遗言
遗嘱 => 遗言
颐养 => 保养
疑惑 => 困惑
疑神疑鬼 => 捕风捉影
疑心 => 怀疑
已往 => 过去
以讹传讹 => 耳食之言
以后 => 今后
以邻为壑 => 嫁祸于人
以是 => 所以
以手加额 => 额手称庆
以为 => 认为
以牙还牙 => 以眼还眼
以致 => 乃至
义父 => 寄父
义军 => 义师
义师 => 义军
义士 => 烈士
义务 => 责任
义正辞严 => 理直气壮
义冢 => 公墓
议决 => 经过议定
议论 => 群情
议论文 => 论说文
屹立 => 矗立
屹然 => 耸然
异邦 => 番邦
异景 => 奇观
异口同声 => 众口一词
异乡 => 他乡
异议 => 贰言
异族 => 外族
役夫 => 夫子
抑低 => 贬抑
抑扬 => 顿挫
抑制 => 克制
译员 => 舌人
易服 => 换衣
奕棋 => 对奕
轶群 => 超群
谊母 => 干娘
翌日 => 来日诰日
逸群绝俗 => 超群脱俗
意得志满 => 踌躇满志
意会 => 领悟
意见 => 看法
意见意义 => 趣味
意料 => 料想
意气相合 => 气味相投
意气消沉 => 心灰意冷
意气扬扬 => 洋洋得意
意外 => 不测
臆测 => 揣测
臆则屡中 => 料事如神
因此 => 是以
因地制宜 => 随机应变
因祸得福 => 塞翁失马
因利乘便 => 顺水推舟
因素 => 身分
因循自误 => 过后行兵
因噎废食 => 剖腹藏珠
因由 => 起因
因缘 => 人缘
阴碍 => 妨碍
阴暗 => 昏暗
阴差阳错 => 鬼使神差
阴沉 => 阴森
阴沟 => 暗沟
阴谋 => 诡计
阴谋诡计 => 鬼域伎俩
阴森 => 阴沉
阴森森 => 黑沉沉
阴阳怪气 => 古里古怪
阴影 => 暗影
荫庇 => 庇荫
音调 => 声调
音律 => 乐律
殷勤 => 周到
淫乱 => ***
银号 => 钱庄
夤缘 => 趋奉
引车卖浆 => 贩夫走卒
引导 => 引诱
引动 => 哄动
引发 => 激发
引港 => 领港
引火烧身 => 惹火烧身
引火线 => 导火线
引经据典 => 旁征博引
引颈就戮 => 束身待罪
引狼入室 => 开门揖盗
引人 => 惹人
引人入胜 => 令人着迷
引诱 => 引导
饮茶 => 吃茶品茗
饮酒 => 喝酒
饮马投钱 => 贪污舞弊
饮鸩止渴 => 牵萝补屋
隐蔽 => 隐藏
隐藏 => 隐蔽
隐恶扬善 => 遏恶扬善
隐讳 => 忌讳
隐士 => 山人
隐隐 => 隐约
隐语 => 切口
隐约 => 模糊
印子钱 => 高利贷
应当 => 应该
应付 => 敷衍
应付裕如 => 应付自如
应付自如 => 应付裕如
应该 => 应当
应命 => 报命
应声 => 回声
应用 => 运用
应有尽有 => 包罗万象
英豪 => 英雄
英华 => 精华
英魂 => 英灵
英俊 => 漂亮
英灵 => 英魂
英明 => 贤明
英气 => 豪气
英雄 => 豪杰
英雄仗义 => 豪侠好义
英勇 => 勇敢
莺啼燕语 => 鸟语花香
鹰视 => 虎睨
迎合 => 逢迎
迎刃而解 => 水到渠成
盈余 => 红利
营垒 => 堡垒
营生 => 谋生
营私舞弊 => 假公济私
营养 => 养分
萦绕 => 缭绕
赢得 => 博得
赢利 => 赚钱
颖慧 => 颖悟
颖悟 => 颖慧
影射 => 暗射
影戏 => 电影
影象 => 记忆
硬朗 => 结实
佣钿 => 回佣
拥戴 => 拥护
拥护 => 拥戴
庸人自扰 => 杞人忧天
庸俗 => 俗气
庸庸碌碌 => 栗六庸才
壅闭 => 阻塞
臃肿 => 痴肥
喁喁私语 => 切切私语
喁喁细语 => 咕咕唧唧
永劫 => 长时
永久 => 永远
永日 => 长日
永生 => 长生
永世 => 永久
永夜 => 长夜
永远贬抑 => 不再任用
勇敢 => 大胆
勇猛 => 英勇
勇往直前 => 一往无前
涌现 => 出现
用场 => 用处
用处 => 用途
用度 => 费用
用饭 => 吃饭
用具 => 器具
用途 => 用处
用心 => 居心
优点 => 长处
优良 => 优秀
优劣 => 好坏
优美 => 幽美
优胜 => 优越
优秀 => 优良
优异 => 优良
优越 => 优胜
忧愁 => 忧闷
忧国忧民 => 伤时感事
忧惧 => 恐忧
忧心忡忡 => 内心不安
忧心如捣 => 忧心如焚
忧郁 => 愁闷
幽禁 => 软禁
幽静 => 安静
幽灵 => 鬼魂
幽美 => 优美
幽默 => 滑稽
幽深 => 幽邃
幽邃 => 幽深
幽香 => 清香
悠长 => 悠久
悠久 => 悠长
悠然自得 => 怡然自得
悠闲 => 安闲
悠扬 => 婉转
尤物 => 美人
由由然 => 飘飘然
由于 => 因为
犹如 => 如同
犹豫 => 迟疑
油滑 => 圆滑
油腔滑调 => 嘻皮笑脸
油嘴滑舌 => 油头滑脑
游荡 => 浪荡
游记 => 纪行
游客 => 旅客
游戏人间 => 逢场作戏
游泳 => 泅水
游勇 => 浪人
友爱 => 友好
友邦 => 盟国
友好 => 友爱
友情 => 友谊
友谊 => 友情
有夫之妇 => 罗敷有夫
有口难言 => 百辞莫辩
有良心 => 不忘本
有名 => 著名
有年 => 丰年
有缺 => 出缺
有伤风化 => 伤风败俗
有身 => 怀孕
有声有色 => 有条有理
有失体统 => 不成体统
有始有终 => 好头不如好尾
有数 => 稀有
有所顾忌 => 投鼠忌器
有头无尾 => 虎头蛇尾
有效 => 有用
有用 => 有效
莠民 => 败类
黝黑 => 漆黑
又名 => 别名
幼年 => 少小
幼童 => 小童
幼子 => 季子
诱导 => 引诱
诱饵 => 钓饵
诱骗 => 欺骗
迂腐 => 陈腐
迂回曲折 => 转弯抹角
于归之喜 => 出阁之喜
余存 => 孑遗
鱼雁不绝 => 雁足传书
愉快 => 高兴
愉逸 => 安乐
腴膏 => 膏腴
逾额 => 超额
逾期 => 过期
逾越 => 超越
愚笨 => 愚蠢
愚蠢 => 愚昧
愚钝 => 痴顽
愚见 => 鄙意
愚昧 => 愚蠢
愚拙 => 呆笨
舆图 => 地图
舆志 => 地志
与你何关 => 干卿底事
与日俱增 => 一日千里
与众不同 => 不同凡响
宇量 => 气量
羽缎 => 哔叽
羽化 => 成仙
羽觞 => 酒杯
羽士 => 道士
羽书 => 军书
语言 => 说话
玉帛 => 财宝
玉成 => 成全
玉轮 => 月亮
玉人 => 美女
玉山颓倒 => 烂醉如泥
玉石同烬 => 兰艾俱焚
玉体 => 贵体
玉液琼浆 => 金樽旨酒
郁勃 => 兴盛
郁闷 => 愁闷
浴池 => 混堂
预报 => 预告
预备 => 准备
预测 => 猜测
预感 => 预见
预计 => 估计
预见 => 预感
预料 => 预感
预言家 => 先觉
预兆 => 前兆
预支 => 预付
欲罢不能 => 不能自休
欲盖弥彰 => 此地无银三百两
欲望 => 愿望
欲言又止 => 半吐半吞
寓目 => 观看
寓所 => 居所
寓意 => 寄意
御医 => 太医
遇到 => 碰到
遇见 => 碰见
遇人不淑 => 所嫁非人
遇上 => 赶上
愈甚 => 更甚
冤仇 => 仇恨
渊博 => 广博
元配 => 德配
元勋 => 功臣
园地 => 场地
园丁 => 花匠
原本 => 本来
原来 => 本来
原理 => 道理
原谅 => 谅解
原先 => 本来
原形 => 本相
原形毕露 => 暴露无遗
圆滑 => 油滑
圆满 => 美满
圆通 => 光滑油滑
援救 => 搭救
援军 => 救兵
援助 => 支援
缘故原由 => 原因
缘由 => 启事
源头 => 泉源
源源不绝 => 绵绵不断
源源而来 => 滔滔而至
源远流长 => 积厚流光
远程 => 长途
远大 => 弘远
远而避之 => 退避三舍
远景 => 前景
远望 => 了望
远足 => 郊游
怨愤 => 愤懑
怨嗟 => 叹恨
怨气冲天 => 牢骚满腹
怨天恨地 => 怨天尤人
怨天尤人 => 自怨自艾
怨言 => 牢骚
愿望 => 欲望
约定 => 商定
约莫 => 大约
约请 => 邀请
约束 => 束缚
月白风清 => 清风明月
月晦 => 月终
月老祠 => 撮合山
月朔 => 初一
月尾 => 月底
月下花前 => 花前月下
月牙 => 新月
悦目 => 好看
阅读 => 浏览
阅历 => 经历
跃跃欲动 => 见猎心喜
跃跃欲试 => 伎痒
越发 => 更加
越过 => 超出
越权代理 => 尸祝代庖
越日 => 次日
越狱 => 逃狱
云云 => 如此
匀称 => 均匀
允承 => 慨诺
允从 => 依从
允诺 => 承诺
允许 => 许可
殒命 => 死亡
孕妇 => 妊妇
孕育发生 => 产生
运动 => 活动
运动场 => 体育场
运气 => 命运运限
运送 => 输送
运用 => 应用
韵事 => 佳话
蕴藏 => 储藏
蕴藉 => 含蓄
杂居 => 混居
杂乱 => 混乱
杂念 => 邪念
杂税 => 冗赋
杂务 => 琐务
灾害 => 灾祸
灾患丛生 => 祸不单行
灾祸 => 灾害
灾黎 => 难民
灾民 => 流民
灾难 => 灾害
宰衡 => 首相
再见 => 再会
再醮 => 改嫁
再起 => 复兴
再娶 => 另娶
再三告诫 => 三令五申
再造之恩 => 二天之德
在朝 => 执政
在即 => 期近
在世 => 活着
在下 => 鄙人
暂时 => 临时
暂休 => 少憩
赞成 => 赞同
赞美 => 赞扬
赞赏 => 赞美
赞颂 => 赞扬
赞同 => 赞成
赞许 => 赞成
赞扬 => 赞赏
赞助 => 资助
葬送 => 断送
遭受 => 遭遇
遭遇 => 遭受
遭灾 => 罹难
糟糠 => 荆布
糟蹋 => 浪费
早安 => 晨安
早晨 => 凌晨
早春 => 初春
早起 => 夙兴
早晚 => 日夕
早霞 => 朝霞
早先 => 起初
造次 => 冒昧
造访 => 访问
造就 => 培养
造谣生事 => 构词惑众
造诣 => 成就
造诣高深 => 升堂入室
造作 => 做作
择要 => 摘要
责备 => 责怪
责怪 => 责备
责任 => 义务
齰舌 => 惊叹
怎样 => 如何
怎知 => 安知
增补 => 补充
增长 => 增加
增加 => 增长
增进 => 促进
增强 => 加强
增添 => 增加
增援 => 支援
憎恨 => 仇恨
赠送 => 赠予
赠医 => 施医
渣滓 => 残余
扎脚 => 裹足
扎营 => 安营
乍寒乍热 => 忽冷忽热
诈财 => 骗财
诈骗 => 欺骗
炸药 => 火药
宅券 => 房契
宅忧 => 居忧
宅兆 => 坟墓
债主 => 借主
沾恩 => 受惠
沾光 => 叨光
沾染 => 感染
瞻仰 => 仰望
斩柴 => 伐木
展开 => 睁开
展览场 => 陈列所
展览会 => 博览会
展示 => 展现
展望 => 瞻望
展现 => 展示
崭露锋芒 => 崭露头角
崭新 => 极新
占据 => 占领
占领 => 占据
占有 => 占领
战场 => 疆场
战斗 => 战役
战功 => 军功
战略 => 计谋
战胜 => 克服
战士 => 兵士
战死沙场 => 马革裹尸
战役 => 战斗
战云浓密 => 鼙鼓雷鸣
战战兢兢 => 小心翼翼
战争 => 战斗
张皇 => 慌张
张口结舌 => 瞠目结舌
张罗 => 筹措
张望 => 观望
张扬 => 声张
彰明较着 => 明白昭彰
蟑螂 => 甲由
掌上河山 => 尺幅千里
掌握 => 控制
掌珠 => 令嫒
丈量 => 测量
仗势欺人 => 狐假虎威
招待 => 接待
招抚 => 招安
招供 => 供认
招呼 => 召唤
招架 => 抵挡
招徕 => 兜揽
招聘 => 雇用
招摇撞骗 => 冒名行骗
招展 => 飘扬
招招手 => 挥挥手
昭示 => 明示
昭雪 => 平反
找事 => 谋事
沼泽 => 池沼
召唤 => 呼唤
召募 => 募集
召盘 => 出顶
诏书 => 圣旨
照拂 => 垂问咨询人
照功行赏 => 论功行赏
照顾 => 照料
照顾护士 => 护理
照旧 => 还是
照例 => 按例
照料 => 照顾
照射 => 照耀
照相 => 拍照
照耀 => 照射
照应 => 照顾
照映 => 辉映
肇始 => 起始
肇事 => 生事
遮蔽 => 掩蔽
遮道挽留 => 攀辕卧辙
遮盖 => 隐瞒
遮掩 => 遮蔽
折扣 => 扣头
折磨 => 熬煎
折辱 => 挫辱
折衷 => 调和
哲人其萎 => 兰摧玉折
蛰伏 => 冬眠
这次 => 此次
这天 => 是日
这样 => 如许
针砭 => 规戒
针砭箴规 => 忠告
针砭之语 => 药石之言
针言 => 成语
侦查 => 侦察
侦察 => 侦查
侦缉队 => 刑警队
侦骑 => 逻骑
侦探 => 侦察
珍爱 => 珍重
珍宝 => 至宝
珍藏 => 收藏
珍贵 => 名贵
珍奇 => 珍异
珍视 => 器重
珍惜 => 珍爱
珍重 => 珍爱
真诚 => 真挚
真谛 => 真理
真个 => 端的
真话 => 实话
真理 => 真谛
真切 => 逼真
真相 => 本相
真相大白 => 水落石出
真心实意 => 推心置腹
真挚 => 真诚
斟酌 => 推敲
箴规 => 针砭
箴言 => 规语
枕戈待旦 => 常备不懈
枕席 => 床笫
轸慕 => 痛念
缜密 => 周密
阵容 => 声威
阵势 => 地势
鸩酒 => 毒酒
鸩杀 => 毒杀
振臂一呼 => 登高一呼
振弱除暴 => 锄强扶弱
赈济 => 施助
镇定 => 镇静
镇静 => 沉着
镇日 => 竟日
镇痛剂 => 麻醉剂
震怖 => 慑伏
震荡 => 震动
震动 => 震撼
震撼 => 震动
震惊 => 震动
震怒 => 大怒
震天动地 => 惊天动地
争辩 => 辩论
争夺 => 争取
争分夺秒 => 分秒必争
争论 => 争辩
争取 => 争夺
争先 => 抢先
争艳 => 斗丽
征采 => 搜寻
征伐 => 挞伐
征服 => 驯服
征请 => 征聘
征求 => 收罗
征象 => 现象
征战 => 交战
挣脱 => 摆脱
睁开 => 展开
拯民水火 => 解民倒悬
整顿 => 整理
整个 => 全部
整理 => 整顿
整年 => 全年
整齐 => 整洁
整日 => 全日
整天 => 成天
整装 => 束装
正本清源 => 根本治理
正大光明 => 光明磊落
正当 => 合法
正法 => 处死
正犯 => 主犯
正路 => 正途
正派 => 正直
正派人物 => 正人君子
正确 => 准确
正事主 => 本事儿
正是 => 恰是
正途 => 正路
正义 => 公理
正直 => 正派
正中下怀 => 恰如私愿
证明 => 证实
郑重 => 慎重
政府 => 当局
政界 => 官场
症结 => 关键
支撑 => 支持
支持 => 支撑
支付 => 付出
支解 => 分割
支路 => 歧路
支配 => 安排
支援 => 增援
支属 => 亲属
枝节横生 => 添枝加叶
知己 => 亲信
知交 => 厚交
知名 => 著名
知难而退 => 功成身退
知趣 => 识相
知识 => 常识
知无不言 => 各抒己见
知心 => 贴心
脂粉气 => 女儿态
执拗 => 固执
执法 => 法律
执法如山 => 言出法随
执绋 => 送葬
执迷不悟 => 死心塌地
执行 => 履行
执政 => 在朝
直捣黄龙 => 犁庭扫穴
直肚直肠 => 心直口快
直谏 => 切谏
直立 => 竖立
直率 => 直爽
直爽 => 直率
直通 => 纵贯
职能 => 本能机能
职权 => 权柄
职位地方 => 地位
职员 => 人员
止境 => 尽头
只管 => 尽管
只管即便 => 尽量
只身 => 单身
纸墨笔砚 => 文房四宝
纸上谈兵 => 空言无补
指导 => 指点
指点 => 指导
指挥 => 批示
指鸡骂犬 => 指桑骂槐
指模 => 手印
指示 => 指导
指手画脚 => 比手划脚
指责 => 责备
指正 => 斧正
至高无上 => 登峰造极
至公 => 大公
至好 => 至交
至死不悟 => 顽固不化
至死不渝 => 执迷不悟
至心 => 真心
志薄云霄 => 凌云壮志
志得意满 => 沾沾自喜
志愿 => 自愿
制订 => 制定
制定 => 制订
制度 => 轨制
制服 => 礼服
制品 => 成品
制造 => 制作
制止 => 禁止
制作 => 制造
治罪 => 定罪
质料 => 原料
质朴 => 朴素
栉风沐雨 => 披星戴月
挚友 => 好友
桎梏 => 枷锁
致歉 => 道歉
致谢 => 申谢
致意 => 请安
掷中 => 命中
窒息 => 梗塞
智慧 => 聪明
智囊 => 军师
稚子 => 幼稚
置若罔闻 => 熟视无睹
置之不理 => 置之度外
中断 => 中止
中分 => 平分
中怀怨恨 => 仇隙在心
中计 => 上钩
中间 => 中央
中流砥柱 => 国家栋梁
中途 => 半途
中午 => 正午
中心 => 中间
中心人物 => 核心分子
中央 => 中心
中庸之道 => 不偏不倚
中用 => 顶用
中原 => 华夏
中止 => 中断
忠诚 => 忠实
忠肝义胆 => 赤血丹心
忠告 => 忠言
忠厚 => 忠诚
忠实 => 忠诚
忠心耿耿 => 赤胆忠心
忠言逆耳 => 良药苦口
忠于职守 => 毋忝厥职
终极 => 最终
终究 => 毕竟
终年 => 长年
终身 => 毕生
终生 => 毕生
终生一生没世 => 毕生
钟灵毓秀 => 人杰地灵
种别 => 类别
种花 => 莳花
种田 => 耕田
种植 => 栽种
种种 => 各种
仲春 => 二月
仲父 => 季父
众多 => 浩瀚
众寡不敌 => 众寡悬殊
众口称善 => 口碑载道
众口纷纭 => 众说纷纭
众口一词 => 异口同声
众怒 => 公愤
众擎易举 => 众志成城
众人 => 世人
众说纷纭 => 众口纷纭
众志成城 => 众擎易举
重版 => 再版
重办 => 严惩
重病 => 宿疾
重酬 => 厚酬
重担 => 重任
重复 => 反复
重利 => 厚利
重任 => 重担
重色轻友 => 见色忘友
重生 => 更生
重视 => 看重
重新 => 从新
重新努力别辟门户 => 另起炉灶
重修 => 重建
重要 => 主要
重义轻财 => 疏财仗义
重作冯妇 => 前度刘郎
州官放火 => 明知故犯
州里 => 乡镇
舟中敌国 => 亲信背叛
舟子 => 船夫
周到 => 周密
周密 => 严密
周围 => 四周
周游 => 漫游
周遭 => 方圆
咒骂 => 诅咒
昼寝 => 午睡
昼夜 => 日夜
籀文 => 大篆
朱唇皓齿 => 唇红齿白
朱颜 => 红颜
朱紫 => 贵人
诛求无厌 => 苟求不已
诛讨 => 讨伐
株连 => 连累
株式会社 => 股份有限公司
珠光宝气 => 翠绕珠围
珠圆玉润 => 肌理丰盈
诸多忌惮 => 缩手缩脚
猪狗不如 => 狗彘不若
猪朋狗友 => 酒肉朋友
竹苞松茂 => 美轮美奂
竹篱 => 篱笆
烛炬 => 蜡烛
逐步 => 慢慢
逐日 => 每日
逐一 => 一一
主笔 => 编缉
主动 => 自动
主干 => 骨干
主顾 => 顾主
主见 => 主意
主理 => 主办
主要 => 重要
主意 => 主张
主张 => 主意
主旨 => 宗旨
主座 => 长官
煮荳燃萁 => 同室操戈
煮饭 => 烧饭
嘱咐 => 吩咐
瞩目 => 注视
伫候 => 鹄候
伫立 => 鹄立
住持僧人 => 方丈和尚
住民 => 居民
住所 => 居处
住宅 => 室庐
助桀为虐 => 助纣为虐
助势 => 助威
注目 => 注视
注射 => 打针
注视 => 注目
注水 => 灌水
注销 => 刊出
注意 => 留意
注意灌输 => 灌入
注重 => 重视
驻足 => 立足
祝贺 => 祝愿
祝融 => 回禄
祝愿 => 祝贺
著名 => 有名
蛀牙 => 龋齿
铸造 => 锻造
爪牙 => 帮凶
专长 => 特长
专程 => 特地
专断 => 独断
专权 => 擅权
专心致志 => 收视反听
专制 => 独裁
转败为功 => 化险为夷
转班 => 调班
转悲为喜 => 破涕为笑
转变 => 改变
转达 => 传达
转动 => 迁移转变
转机 => 起色
转蓬 => 秋蓬
转让 => 让渡
转身 => 回身
转瞬之间 => 弹指之间
转头 => 回头
转弯抹角 => 迂回曲折
转业 => 改行
转意 => 回心
妆奁 => 嫁妆
庄家 => 农户
庄严 => 肃静
庄重 => 稳重
装扮 => 打扮
装备 => 设备
装点 => 点缀
装潢 => 装饰
装甲车 => 坦克车
装腔作势 => 矫揉造作
装饰 => 装潢
装束 => 打扮服装
装置 => 装配
装作 => 假装
壮大 => 强大
壮举 => 豪举
壮丽 => 绚丽
壮年 => 丁壮
壮盛 => 鼎盛
壮实 => 结实
壮志凌云 => 雄心万丈
状况 => 状态
状貌 => 模样形状
状师 => 律师
状态 => 状况
追悼 => 悲悼
追风逐电 => 风驰电掣
追悔不及 => 后悔无及
追究 => 穷究
追念 => 回想
追求 => 寻求
追随 => 跟随
追随骥尾 => 步人后尘
追讨 => 催讨
坠欢重拾 => 破镜重圆
赘瘤 => 肉瘤
谆谆教导 => 循循善诱
谆谆教诲 => 耳提面命
准备 => 预备
准假 => 给假
准期 => 如期
准确 => 精确
准绳 => 绳尺
卓荦不群 => 超绝群伦
卓识 => 卓见
卓越 => 卓著
卓著 => 卓越
拙荆 => 山妻
拙劣 => 低劣
捉襟见肘 => 左支右绌
捉拿 => 缉捕
捉住 => 抓住
灼热 => 炽热
灼烁 => 光明
浊世 => 乱世
酌定 => 裁夺
着花 => 开花
着急 => 焦急
着力 => 出力
着落 => 下落
着迷 => 入神
着名 => 知名
着末 => 末了
着实 => 实在
着手成春 => 手到回春
着重 => 侧重
着着失败 => 节节失利
琢磨 => 揣摩
斲丧 => 消耗
仔细 => 细心
姿势 => 姿态
姿态 => 姿势
资本 => 本钱
资格 => 资历
资历 => 资格
资料 => 材料
资源 => 资本
资质 => 天资
资助 => 赞助
孳生 => 繁殖
孳孳不息 => 勤学不辍
滋长 => 滋生
滋扰 => 干扰
滋润 => 润泽津润
滋生 => 滋长
子弹 => 枪弹
子弟 => 后辈
子女 => 后代
子息 => 后世昆裔
子虚乌有 => 化为乌有
子夜 => 半夜
子音 => 辅音
字画 => 书画
字迹 => 笔迹
字谜 => 灯谜
字斟句酌 => 精益求精
自傲 => 自负
自暴自弃 => 安于现状
自卑过甚 => 自暴自弃
自察 => 内省
自持 => 矜持
自出机杼 => 别出心裁
自大 => 自信
自动 => 主动
自发 => 自觉
自负 => 自信
自甘堕落 => 苟且偷安
自感汗颜 => 自愧弗如
自告奋勇 => 挺身而出
自豪 => 骄傲
自己 => 本身
自尽 => 自杀
自觉 => 自发
自夸 => 自诩
自满 => 骄傲
自鸣得意 => 趾高气扬
自命不凡 => 孤芳自赏
自然 => 天然
自若 => 自如
自身难保 => 自顾不暇
自食其力 => 白手起家
自私自利 => 利欲熏心
自我介绍 => 毛遂自荐
自新 => 改过
自信 => 自负
自诩 => 自夸
自由式泳法 => 爬泳
自在 => 安闲
自制 => 克己
自主 => 自立
自主国 => 独立国
自坠陷阱 => 自投罗网
自尊 => 自负
自作打算 => 善自为谋
自作掩饰 => 自圆其说
自作自受 => 作法自毙
恣意 => 任意
宗旨 => 主旨
宗子 => 长子
踪迹 => 踪影
踪影 => 踪迹
总论 => 泛论
总是 => 老是
纵火 => 放火
纵目 => 极目
纵情 => 尽情
纵然 => 即使
纵脱 => 放荡
走访 => 访问
走狗 => 走卒
走漏 => 泄漏
走马看花 => 浮光掠影
走私 => 私运
走走 => 逛逛
走卒 => 走狗
奏乐 => 吹打
奏琴 => 弹琴
租金 => 房钱
足迹 => 萍踪
足数 => 够数
诅咒 => 咒骂
阻当 => 阻梗
阻挡 => 阻拦
阻遏 => 隔绝
阻拦 => 阻挡
阻挠 => 阻拦
阻塞 => 壅塞
阻止 => 阻拦
组成 => 构成
俎上肉 => 釜中鱼
祖传 => 家传
祖国 => 故国
